//MAP CONVERTED BY dmm2tgm.py THIS HEADER COMMENT PREVENTS RECONVERSION, DO NOT REMOVE
"a" = (
/turf/simulated/open,
/area/tradehouse_wasteland)
"b" = (
/obj/effect/landmark/map_data{
	height = 2
	},
/turf/simulated/open,
/area/tradehouse_wasteland)
"c" = (
/turf/simulated/wall/plaster,
/area/medical/surgery)
"d" = (
/obj/structure/iv_drip,
/obj/item/weapon/reagent_containers/ivbag/blood/OMinus,
/obj/item/weapon/reagent_containers/ivbag/blood/OMinus,
/obj/item/weapon/reagent_containers/ivbag/blood/OMinus,
/turf/simulated/floor/wood/mahogany,
/area/medical/surgery)
"e" = (
/obj/machinery/optable,
/turf/simulated/floor/wood/mahogany,
/area/medical/surgery)
"f" = (
/obj/machinery/computer/operating,
/turf/simulated/floor/wood/mahogany,
/area/medical/surgery)
"g" = (
/obj/structure/table/glass,
/obj/item/weapon/storage/box/syringes,
/obj/item/weapon/storage/box/freezer,
/turf/simulated/floor/wood/mahogany,
/area/medical/surgery)
"h" = (
/obj/structure/table/glass,
/obj/item/weapon/storage/box/gloves,
/obj/item/weapon/storage/box/masks,
/turf/simulated/floor/wood/mahogany,
/area/medical/surgery)
"i" = (
/obj/item/weapon/flame/torch/lit,
/turf/simulated/floor/wood/mahogany,
/area/medical/surgery)
"j" = (
/obj/structure/lattice,
/turf/simulated/open,
/area/medical/surgery)
"l" = (
/obj/structure/table/glass,
/obj/item/weapon/storage/firstaid/surgery,
/turf/simulated/floor/wood/mahogany,
/area/medical/surgery)
"m" = (
/obj/structure/hygiene/sink{
	icon_state = "sink";
	dir = 4
	},
/turf/simulated/floor/wood/mahogany,
/area/medical/surgery)
"n" = (
/turf/simulated/open,
/area/medical/surgery)
"o" = (
/obj/structure/table/glass,
/obj/item/weapon/reagent_containers/dropper,
/obj/item/weapon/reagent_containers/chem_disp_cartridge/peridaxon,
/obj/item/stack/nanopaste,
/turf/simulated/floor/wood/mahogany,
/area/medical/surgery)
"p" = (
/obj/machinery/body_scanconsole{
	icon_state = "body_scannerconsole";
	dir = 4
	},
/turf/simulated/floor/wood/mahogany,
/area/medical/surgery)
"q" = (
/obj/machinery/bodyscanner{
	icon_state = "body_scanner_0";
	dir = 4
	},
/turf/simulated/floor/wood/mahogany,
/area/medical/surgery)
"r" = (
/obj/machinery/sleeper{
	icon_state = "sleeper_0";
	dir = 8
	},
/turf/simulated/floor/wood/mahogany,
/area/medical/surgery)
"s" = (
/obj/machinery/light_switch{
	pixel_x = 25
	},
/turf/simulated/floor/wood/mahogany,
/area/medical/surgery)
"t" = (
/obj/structure/table/glass,
/obj/item/weapon/scalpel/laser1,
/obj/item/weapon/scalpel/laser2,
/obj/item/weapon/scalpel/laser3,
/obj/item/device/robotanalyzer,
/obj/item/device/scanner/health,
/obj/item/weapon/storage/firstaid/adv,
/turf/simulated/floor/wood/mahogany,
/area/medical/surgery)
"u" = (
/obj/structure/ladder/updown,
/turf/simulated/floor/wood/mahogany,
/area/medical/surgery)
"v" = (
/obj/machinery/atmospherics/unary/freezer,
/turf/simulated/floor/wood/mahogany,
/area/medical/surgery)
"w" = (
/obj/machinery/atmospherics/unary/cryo_cell,
/turf/simulated/floor/wood/mahogany,
/area/medical/surgery)
"x" = (
/obj/machinery/portable_atmospherics/canister/oxygen/prechilled,
/obj/machinery/atmospherics/portables_connector,
/turf/simulated/floor/wood/mahogany,
/area/medical/surgery)
"z" = (
/obj/structure/closet/secure_closet/freezer/meat,
/turf/simulated/floor/wood/mahogany,
/area/medical/surgery)
"A" = (
/obj/machinery/robotics_fabricator,
/turf/simulated/floor/wood/mahogany,
/area/medical/surgery)
"B" = (
/obj/machinery/atmospherics/pipe/simple/visible/blue{
	icon_state = "intact";
	dir = 5
	},
/turf/simulated/floor/wood/mahogany,
/area/medical/surgery)
"C" = (
/obj/machinery/atmospherics/pipe/manifold/visible/blue,
/obj/item/weapon/reagent_containers/glass/beaker/cryoxadone,
/turf/simulated/floor/wood/mahogany,
/area/medical/surgery)
"D" = (
/obj/machinery/atmospherics/pipe/simple/visible/blue{
	icon_state = "intact";
	dir = 9
	},
/turf/simulated/floor/wood/mahogany,
/area/medical/surgery)
"E" = (
/obj/machinery/atmospherics/unary/vent_pump/on,
/turf/simulated/floor/wood/mahogany,
/area/medical/surgery)
"F" = (
/obj/machinery/organ_printer/flesh/mapped,
/turf/simulated/floor/wood/mahogany,
/area/medical/surgery)
"G" = (
/obj/machinery/atmospherics/pipe/simple/visible{
	icon_state = "intact";
	dir = 5
	},
/turf/simulated/floor/wood/mahogany,
/area/medical/surgery)
"H" = (
/obj/machinery/atmospherics/pipe/simple/visible{
	icon_state = "intact";
	dir = 4
	},
/turf/simulated/floor/wood/mahogany,
/area/medical/surgery)
"I" = (
/obj/machinery/atmospherics/portables_connector{
	icon_state = "map_connector";
	dir = 8
	},
/obj/machinery/portable_atmospherics/canister/air,
/turf/simulated/floor/wood/mahogany,
/area/medical/surgery)
"J" = (
/obj/machinery/organ_printer/robot/mapped,
/turf/simulated/floor/wood/mahogany,
/area/medical/surgery)
"K" = (
/obj/structure/table/rack,
/obj/item/stack/material/plasteel/fifty,
/obj/item/stack/material/steel/fifty,
/obj/item/stack/material/glass/fifty,
/obj/item/stack/material/gold/ten,
/obj/item/stack/material/mhydrogen/ten,
/obj/item/stack/material/silver/ten,
/obj/item/stack/material/uranium/ten,
/obj/item/stack/material/diamond/ten,
/obj/item/stack/material/phoron/fifty,
/obj/item/weapon/storage/belt/utility/full,
/obj/item/stack/material/steel/fifty,
/turf/simulated/floor/wood/mahogany,
/area/medical/surgery)
"L" = (
/obj/machinery/atmospherics/pipe/simple/visible{
	icon_state = "intact";
	dir = 6
	},
/turf/simulated/floor/wood/mahogany,
/area/medical/surgery)
"M" = (
/obj/machinery/atmospherics/portables_connector{
	icon_state = "map_connector";
	dir = 8
	},
/obj/machinery/portable_atmospherics/canister/empty,
/turf/simulated/floor/wood/mahogany,
/area/medical/surgery)
"N" = (
/obj/machinery/light_switch{
	pixel_x = -25
	},
/turf/simulated/floor/wood/mahogany,
/area/medical/surgery)
"O" = (
/obj/machinery/atmospherics/unary/vent_scrubber/on{
	icon_state = "map_scrubber_on";
	dir = 1
	},
/turf/simulated/floor/wood/mahogany,
/area/medical/surgery)
"Q" = (
/obj/structure/cable{
	d2 = 2;
	icon_state = "0-2";
	pixel_y = 0
	},
/obj/machinery/power/apc{
	dir = 8;
	name = "west bump";
	pixel_x = -24
	},
/turf/simulated/floor/wood/mahogany,
/area/medical/surgery)
"R" = (
/obj/structure/cable{
	d1 = 1;
	d2 = 2;
	icon_state = "1-2";
	pixel_y = 0
	},
/turf/simulated/floor/wood/mahogany,
/area/medical/surgery)
"S" = (
/obj/structure/cable,
/obj/machinery/power/debug_items/infinite_generator,
/turf/simulated/floor/wood/mahogany,
/area/medical/surgery)
"T" = (
/turf/simulated/floor/wood/mahogany,
/area/medical/surgery)
"U" = (
/turf/simulated/floor/tiled/monotile,
/area/tradehouse_rooftops)
"V" = (
/obj/structure/ladder/up,
/turf/simulated/open,
/area/tradehouse_rooftops)

(1,1,1) = {"
a
a
a
a
a
a
a
a
a
a
a
a
a
a
a
a
a
a
a
a
a
a
a
a
a
a
a
a
a
a
a
a
"}
(2,1,1) = {"
a
a
a
a
a
a
a
a
a
a
a
a
a
a
a
a
a
a
a
a
a
a
a
a
a
a
a
a
a
a
a
a
"}
(3,1,1) = {"
a
a
a
a
a
a
a
a
a
a
a
a
a
a
a
a
a
a
a
a
a
a
a
a
a
a
a
a
a
a
a
a
"}
(4,1,1) = {"
a
a
a
a
a
a
a
a
a
a
a
a
a
a
a
a
a
a
a
a
a
a
a
a
a
a
a
a
a
a
a
a
"}
(5,1,1) = {"
a
a
a
a
a
a
a
a
a
a
a
a
a
a
a
a
a
a
a
a
a
a
a
a
a
a
a
a
a
a
a
a
"}
(6,1,1) = {"
a
a
a
a
a
a
U
U
U
U
U
U
U
U
U
a
a
a
a
a
a
a
a
a
a
a
a
a
a
a
a
a
"}
(7,1,1) = {"
a
a
a
a
a
a
U
U
U
U
U
U
U
U
U
a
a
a
a
a
a
a
a
a
a
a
a
a
a
a
a
a
"}
(8,1,1) = {"
a
a
a
a
a
a
U
U
U
U
U
U
U
U
U
a
a
a
a
a
a
a
a
a
a
a
a
a
a
a
a
a
"}
(9,1,1) = {"
a
a
a
a
a
a
U
U
U
U
U
U
U
U
U
a
a
a
a
a
a
a
a
a
a
a
a
a
a
a
a
a
"}
(10,1,1) = {"
a
a
a
a
a
a
U
U
U
U
U
U
U
U
U
a
a
a
a
a
a
a
a
a
a
a
a
a
a
a
a
a
"}
(11,1,1) = {"
a
a
a
a
a
a
U
U
U
U
U
U
U
U
U
a
a
a
a
a
a
a
a
a
a
a
a
a
a
a
a
a
"}
(12,1,1) = {"
a
a
a
a
a
a
U
U
V
U
U
U
U
U
U
a
a
a
a
a
a
a
a
a
a
a
a
a
a
a
a
a
"}
(13,1,1) = {"
a
a
a
a
a
a
U
U
U
U
U
U
U
U
U
a
a
a
a
a
a
a
a
a
a
a
a
a
a
a
a
a
"}
(14,1,1) = {"
a
a
a
a
a
a
U
U
U
U
U
U
U
U
U
a
a
a
a
a
a
a
a
a
a
a
a
a
a
a
a
a
"}
(15,1,1) = {"
a
a
a
a
a
a
a
a
a
b
a
a
a
a
a
a
a
a
a
a
a
a
a
a
a
a
a
a
a
a
a
a
"}
(16,1,1) = {"
a
a
a
a
a
a
a
a
a
a
a
a
a
a
a
a
a
a
a
a
a
a
a
a
a
a
a
a
a
a
a
a
"}
(17,1,1) = {"
a
a
a
a
a
a
a
a
a
a
a
a
a
a
a
a
a
a
a
a
a
a
a
a
a
a
a
a
a
a
a
a
"}
(18,1,1) = {"
a
a
a
a
a
a
a
a
a
c
c
c
c
c
c
c
c
c
c
c
c
c
c
c
a
a
a
a
a
a
a
a
"}
(19,1,1) = {"
a
a
a
a
a
a
a
a
a
c
d
l
o
t
z
F
J
T
N
T
Q
R
S
c
a
a
a
a
a
a
a
a
"}
(20,1,1) = {"
a
a
a
a
a
a
a
a
a
c
e
T
p
i
T
T
T
T
T
T
T
T
i
c
a
a
a
a
a
a
a
a
"}
(21,1,1) = {"
a
a
a
a
a
a
a
a
a
c
f
T
q
T
A
T
K
T
T
T
T
T
T
c
a
a
a
a
a
a
a
a
"}
(22,1,1) = {"
a
a
a
a
a
a
a
a
a
c
g
T
T
T
T
T
T
T
T
T
T
T
T
c
a
a
a
a
a
a
a
a
"}
(23,1,1) = {"
a
a
a
a
a
a
a
a
a
c
h
m
r
u
T
T
T
T
T
T
T
T
T
c
a
a
a
a
a
a
a
a
"}
(24,1,1) = {"
a
a
a
a
a
a
a
a
a
c
i
j
n
v
B
T
T
T
T
T
T
T
T
c
a
a
a
a
a
a
a
a
"}
(25,1,1) = {"
a
a
a
a
a
a
a
a
a
c
j
j
n
w
C
T
i
T
T
T
T
T
i
c
a
a
a
a
a
a
a
a
"}
(26,1,1) = {"
a
a
a
a
a
a
a
a
a
c
T
n
n
x
D
T
T
T
T
T
T
T
T
c
a
a
a
a
a
a
a
a
"}
(27,1,1) = {"
a
a
a
a
a
a
a
a
a
c
T
T
T
T
T
T
T
T
T
T
T
T
T
c
a
a
a
a
a
a
a
a
"}
(28,1,1) = {"
a
a
a
a
a
a
a
a
a
c
T
T
T
T
T
T
T
T
T
T
T
T
T
c
a
a
a
a
a
a
a
a
"}
(29,1,1) = {"
a
a
a
a
a
a
a
a
a
c
T
T
T
T
E
G
T
L
O
T
T
T
T
c
a
a
a
a
a
a
a
a
"}
(30,1,1) = {"
a
a
a
a
a
a
a
a
a
c
i
T
T
T
T
H
T
H
T
T
T
T
i
c
a
a
a
a
a
a
a
a
"}
(31,1,1) = {"
a
a
a
a
a
a
a
a
a
c
T
T
s
T
T
I
T
M
T
T
T
T
T
c
a
a
a
a
a
a
a
a
"}
(32,1,1) = {"
a
a
a
a
a
a
a
a
a
c
c
c
c
c
c
c
c
c
c
c
c
c
c
c
a
a
a
a
a
a
a
a
"}
(33,1,1) = {"
a
a
a
a
a
a
a
a
a
a
a
a
a
a
a
a
a
a
a
a
a
a
a
a
a
a
a
a
a
a
a
a
"}
(34,1,1) = {"
a
a
a
a
a
a
a
a
a
a
a
a
a
a
a
a
a
a
a
a
a
a
a
a
a
a
a
a
a
a
a
a
"}
(35,1,1) = {"
a
a
a
a
a
a
a
a
a
a
a
a
a
a
a
a
a
a
a
a
a
a
a
a
a
a
a
a
a
a
a
a
"}
(36,1,1) = {"
a
a
a
a
a
a
a
a
a
a
a
a
a
a
a
a
a
a
a
a
a
a
a
a
a
a
a
a
a
a
a
a
"}
(37,1,1) = {"
a
a
a
a
a
a
a
a
a
a
a
a
a
a
a
a
a
a
a
a
a
a
a
a
a
a
a
a
a
a
a
a
"}
(38,1,1) = {"
a
a
a
a
a
a
a
a
a
a
a
a
a
a
a
a
a
a
a
a
a
a
a
a
a
a
a
a
a
a
a
a
"}
(39,1,1) = {"
a
a
a
a
a
a
a
a
a
a
a
a
a
a
a
a
a
a
a
a
a
a
a
a
a
a
a
a
a
a
a
a
"}
(40,1,1) = {"
a
a
a
a
a
a
a
a
a
a
a
a
a
a
a
a
a
a
a
a
a
a
a
a
a
a
a
a
a
a
a
a
"}
(41,1,1) = {"
a
a
a
a
a
a
a
a
a
a
a
a
a
a
a
a
a
a
a
a
a
a
a
a
a
a
a
a
a
a
a
a
"}
(42,1,1) = {"
a
a
a
a
a
a
a
a
a
a
a
a
a
a
a
a
a
a
a
a
a
a
a
a
a
a
a
a
a
a
a
a
"}
(43,1,1) = {"
a
a
a
a
a
a
a
a
a
a
a
a
a
a
a
a
a
a
a
a
a
a
a
a
a
a
a
a
a
a
a
a
"}
(44,1,1) = {"
a
a
a
a
a
a
a
a
a
a
a
a
a
a
a
a
a
a
a
a
a
a
a
a
a
a
a
a
a
a
a
a
"}
(45,1,1) = {"
a
a
a
a
a
a
a
a
a
a
a
a
a
a
a
a
a
a
a
a
a
a
a
a
a
a
a
a
a
a
a
a
"}
(46,1,1) = {"
a
a
a
a
a
a
a
a
a
a
a
a
a
a
a
a
a
a
a
a
a
a
a
a
a
a
a
a
a
a
a
a
"}
(47,1,1) = {"
a
a
a
a
a
a
a
a
a
a
a
a
a
a
a
a
a
a
a
a
a
a
a
a
a
a
a
a
a
a
a
a
"}
(48,1,1) = {"
a
a
a
a
a
a
a
a
a
a
a
a
a
a
a
a
a
a
a
a
a
a
a
a
a
a
a
a
a
a
a
a
"}
