//MAP CONVERTED BY dmm2tgm.py THIS HEADER COMMENT PREVENTS RECONVERSION, DO NOT REMOVE
"a" = (
/turf/unsimulated/wasteland_surface,
/area/tradehouse_wasteland)
"b" = (
/turf/simulated/wall/plaster,
/area/constructionsite)
"c" = (
/obj/item/weapon/flame/torch/lit,
/turf/simulated/floor/wood/mahogany,
/area/constructionsite)
"d" = (
/obj/structure/cable,
/obj/machinery/power/debug_items/infinite_generator,
/obj/item/weapon/flame/torch/lit,
/turf/simulated/floor/wood/mahogany,
/area/constructionsite)
"e" = (
/obj/effect/landmark{
	name = "tdome1"
	},
/turf/simulated/floor/wood/mahogany,
/area/constructionsite)
"f" = (
/obj/effect/floor_decal/industrial/hatch/yellow,
/turf/simulated/floor/wood/mahogany,
/area/constructionsite)
"g" = (
/obj/machinery/light_switch{
	pixel_x = 25
	},
/turf/simulated/floor/wood/mahogany,
/area/constructionsite)
"i" = (
/obj/structure/ladder/up,
/turf/simulated/floor/wood/mahogany,
/area/constructionsite)
"k" = (
/obj/machinery/atmospherics/unary/vent_pump/on,
/turf/simulated/floor/wood/mahogany,
/area/constructionsite)
"l" = (
/obj/machinery/atmospherics/pipe/simple/visible{
	icon_state = "intact";
	dir = 5
	},
/turf/simulated/floor/wood/mahogany,
/area/constructionsite)
"m" = (
/obj/machinery/atmospherics/pipe/simple/visible{
	icon_state = "intact";
	dir = 4
	},
/turf/simulated/floor/wood/mahogany,
/area/constructionsite)
"n" = (
/obj/machinery/atmospherics/portables_connector{
	icon_state = "map_connector";
	dir = 8
	},
/obj/machinery/portable_atmospherics/canister/air,
/turf/simulated/floor/wood/mahogany,
/area/constructionsite)
"o" = (
/obj/effect/wingrille_spawn/reinforced,
/turf/unsimulated/wasteland_surface,
/area/shuttle/escape)
"p" = (
/obj/machinery/computer/shuttle_control{
	shuttle_tag = "Tradehouse Wagon"
	},
/turf/unsimulated/wasteland_surface,
/area/shuttle/escape)
"q" = (
/obj/machinery/light_switch{
	pixel_x = -25
	},
/turf/simulated/floor/wood/mahogany,
/area/constructionsite)
"r" = (
/obj/effect/landmark/start,
/turf/simulated/floor/wood/mahogany,
/area/constructionsite)
"s" = (
/obj/structure/bed/chair{
	dir = 1
	},
/obj/machinery/embedded_controller/radio/simple_docking_controller{
	id_tag = "tradehouse_shuttle_starboard";
	pixel_x = 28
	},
/obj/machinery/embedded_controller/radio/simple_docking_controller{
	id_tag = "tradehouse_shuttle_port";
	pixel_x = -28
	},
/obj/effect/shuttle_landmark/lower_level,
/turf/simulated/floor/wood/mahogany,
/area/shuttle/escape)
"t" = (
/obj/effect/landmark/test/safe_turf,
/turf/simulated/floor/wood/mahogany,
/area/constructionsite)
"u" = (
/obj/machinery/atmospherics/pipe/simple/visible{
	icon_state = "intact";
	dir = 6
	},
/turf/simulated/floor/wood/mahogany,
/area/constructionsite)
"v" = (
/obj/machinery/atmospherics/portables_connector{
	icon_state = "map_connector";
	dir = 8
	},
/obj/machinery/portable_atmospherics/canister/empty,
/turf/simulated/floor/wood/mahogany,
/area/constructionsite)
"w" = (
/obj/machinery/door/airlock/external/bolted{
	frequency = 1379;
	id_tag = "tradehouse_shuttle_port_hatch"
	},
/turf/unsimulated/wasteland_surface,
/area/shuttle/escape)
"x" = (
/turf/simulated/floor/wood/mahogany,
/area/shuttle/escape)
"y" = (
/obj/machinery/door/airlock/external/bolted{
	frequency = 1379;
	id_tag = "tradehouse_shuttle_starboard_hatch"
	},
/turf/simulated/floor/wood/mahogany,
/area/shuttle/escape)
"z" = (
/obj/machinery/door/airlock/external/bolted{
	frequency = 1379;
	id_tag = "lower_level_dock_hatch"
	},
/turf/simulated/floor/wood/mahogany,
/area/constructionsite)
"A" = (
/obj/machinery/embedded_controller/radio/simple_docking_controller{
	id_tag = "lower_level_dock";
	pixel_x = -8;
	pixel_y = -25
	},
/turf/simulated/floor/wood/mahogany,
/area/constructionsite)
"B" = (
/obj/machinery/atmospherics/unary/vent_scrubber/on{
	icon_state = "map_scrubber_on";
	dir = 1
	},
/turf/simulated/floor/wood/mahogany,
/area/constructionsite)
"C" = (
/turf/simulated/wall/plaster,
/area/shuttle/escape)
"D" = (
/obj/effect/landmark{
	name = "JoinLate"
	},
/turf/simulated/floor/wood/mahogany,
/area/constructionsite)
"E" = (
/obj/structure/cable{
	d2 = 2;
	icon_state = "0-2";
	pixel_y = 0
	},
/obj/machinery/power/apc{
	dir = 8;
	name = "west bump";
	pixel_x = -24
	},
/turf/simulated/floor/wood/mahogany,
/area/constructionsite)
"F" = (
/obj/structure/cable{
	d1 = 1;
	d2 = 2;
	icon_state = "1-2";
	pixel_y = 0
	},
/turf/simulated/floor/wood/mahogany,
/area/constructionsite)
"H" = (
/turf/simulated/floor/wood/mahogany,
/area/constructionsite)
"I" = (
/obj/effect/landmark/test/space_turf,
/turf/unsimulated/wasteland_surface,
/area/tradehouse_wasteland)
"J" = (
/obj/effect/wingrille_spawn,
/turf/simulated/floor/wood/mahogany,
/area/constructionsite)

(1,1,1) = {"
a
a
a
a
a
a
a
a
a
a
a
a
a
a
a
a
a
a
a
a
a
a
a
a
a
a
a
a
a
a
a
a
"}
(2,1,1) = {"
a
a
a
a
a
a
a
a
a
a
a
a
a
a
a
a
a
a
a
a
a
a
a
a
a
a
a
a
a
a
a
a
"}
(3,1,1) = {"
a
a
a
a
a
a
a
a
a
a
a
a
a
a
a
a
a
a
a
a
a
a
a
a
a
a
a
a
a
a
a
a
"}
(4,1,1) = {"
a
a
a
a
a
a
a
a
a
a
a
a
a
a
a
a
a
a
a
a
a
a
a
a
a
a
a
a
a
a
a
a
"}
(5,1,1) = {"
a
a
a
a
a
a
a
a
a
a
a
a
a
a
a
a
a
a
a
a
a
a
a
a
a
a
a
a
a
a
a
a
"}
(6,1,1) = {"
a
a
a
a
a
a
b
b
b
b
b
J
J
b
b
a
a
a
a
a
a
a
a
a
a
a
a
a
a
a
a
a
"}
(7,1,1) = {"
a
a
a
a
a
a
b
H
H
H
H
H
H
H
b
a
a
a
a
a
a
a
a
a
a
a
a
a
a
a
a
a
"}
(8,1,1) = {"
a
a
a
a
a
a
J
H
c
H
H
H
c
H
b
a
a
a
a
a
a
a
a
a
a
a
a
a
a
a
a
a
"}
(9,1,1) = {"
a
a
a
a
a
a
J
H
H
H
H
H
H
H
b
a
a
a
a
a
a
a
a
a
a
a
a
a
a
a
a
a
"}
(10,1,1) = {"
a
a
a
a
a
a
J
H
H
H
H
H
H
H
b
a
a
a
a
a
a
a
a
a
a
a
a
a
a
a
a
a
"}
(11,1,1) = {"
a
a
a
a
a
a
J
H
H
H
H
H
H
H
b
a
a
a
a
a
a
a
a
a
a
a
a
a
a
a
a
a
"}
(12,1,1) = {"
a
a
a
a
a
a
J
H
i
H
H
H
H
H
b
a
a
a
a
a
a
a
a
a
a
a
a
a
a
a
a
a
"}
(13,1,1) = {"
a
a
a
a
a
a
b
H
H
H
H
H
H
H
b
a
o
o
w
C
a
a
a
a
a
a
a
a
a
a
a
a
"}
(14,1,1) = {"
a
a
a
a
a
a
b
b
b
b
J
b
H
H
b
a
p
s
x
C
a
a
a
a
a
a
a
a
a
a
a
a
"}
(15,1,1) = {"
a
a
a
a
a
a
a
a
a
a
a
a
a
a
a
a
o
o
y
C
a
a
a
a
a
a
a
a
a
a
a
a
"}
(16,1,1) = {"
a
a
a
a
a
a
a
a
a
a
a
a
a
a
a
a
a
b
z
b
a
a
a
a
a
a
a
a
a
a
a
a
"}
(17,1,1) = {"
a
a
a
a
a
a
a
a
a
a
a
a
a
a
a
a
a
b
A
b
a
a
a
a
a
a
a
a
a
a
a
a
"}
(18,1,1) = {"
a
a
a
a
a
a
a
a
a
b
J
J
J
b
H
H
b
b
H
b
b
b
b
b
a
a
a
a
a
a
a
a
"}
(19,1,1) = {"
a
a
a
a
a
a
a
a
a
b
c
H
H
H
H
H
q
c
H
H
E
F
d
b
a
a
a
a
a
a
a
a
"}
(20,1,1) = {"
a
a
a
a
a
a
a
a
a
b
H
e
e
e
H
H
H
H
H
H
H
H
H
J
a
a
a
a
a
a
a
a
"}
(21,1,1) = {"
a
a
a
a
a
a
a
a
a
b
H
e
e
e
H
H
H
H
H
D
D
D
H
J
a
a
a
a
a
a
a
a
"}
(22,1,1) = {"
a
a
a
a
a
a
a
a
a
b
H
e
e
e
H
H
H
H
H
D
D
D
H
b
a
a
a
a
a
a
a
a
"}
(23,1,1) = {"
a
a
a
a
a
a
a
a
a
b
H
H
H
i
H
H
H
t
H
D
D
D
H
b
a
a
I
a
a
a
a
a
"}
(24,1,1) = {"
a
a
a
a
a
a
a
a
a
b
H
f
f
f
H
H
H
H
H
H
H
H
H
b
a
a
a
a
a
a
a
a
"}
(25,1,1) = {"
a
a
a
a
a
a
a
a
a
J
c
H
f
f
H
H
r
c
H
H
H
H
c
J
a
a
a
a
a
a
a
a
"}
(26,1,1) = {"
a
a
a
a
a
a
a
a
a
J
H
f
f
f
H
H
H
H
H
H
H
H
H
J
a
a
a
a
a
a
a
a
"}
(27,1,1) = {"
a
a
a
a
a
a
a
a
a
J
H
H
H
H
H
H
H
H
H
H
H
H
H
J
a
a
a
a
a
a
a
a
"}
(28,1,1) = {"
a
a
a
a
a
a
a
a
a
b
H
H
H
H
H
H
H
H
H
H
H
H
H
b
a
a
a
a
a
a
a
a
"}
(29,1,1) = {"
a
a
a
a
a
a
a
a
a
b
H
H
H
H
k
l
H
u
B
H
H
H
H
b
a
a
a
a
a
a
a
a
"}
(30,1,1) = {"
a
a
a
a
a
a
a
a
a
b
H
H
H
H
H
m
H
m
H
H
H
H
H
J
a
a
a
a
a
a
a
a
"}
(31,1,1) = {"
a
a
a
a
a
a
a
a
a
b
c
H
g
H
H
n
c
v
H
H
H
H
c
J
a
a
a
a
a
a
a
a
"}
(32,1,1) = {"
a
a
a
a
a
a
a
a
a
b
J
J
b
b
b
b
b
J
J
J
J
J
b
b
a
a
a
a
a
a
a
a
"}
(33,1,1) = {"
a
a
a
a
a
a
a
a
a
a
a
a
a
a
a
a
a
a
a
a
a
a
a
a
a
a
a
a
a
a
a
a
"}
(34,1,1) = {"
a
a
a
a
a
a
a
a
a
a
a
a
a
a
a
a
a
a
a
a
a
a
a
a
a
a
a
a
a
a
a
a
"}
(35,1,1) = {"
a
a
a
a
a
a
a
a
a
a
a
a
a
a
a
a
a
a
a
a
a
a
a
a
a
a
a
a
a
a
a
a
"}
(36,1,1) = {"
a
a
a
a
a
a
a
a
a
a
a
a
a
a
a
a
a
a
a
a
a
a
a
a
a
a
a
a
a
a
a
a
"}
(37,1,1) = {"
a
a
a
a
a
a
a
a
a
a
a
a
a
a
a
a
a
a
a
a
a
a
a
a
a
a
a
a
a
a
a
a
"}
(38,1,1) = {"
a
a
a
a
a
a
a
a
a
a
a
a
a
a
a
a
a
a
a
a
a
a
a
a
a
a
a
a
a
a
a
a
"}
(39,1,1) = {"
a
a
a
a
a
a
a
a
a
a
a
a
a
a
a
a
a
a
a
a
a
a
a
a
a
a
a
a
a
a
a
a
"}
(40,1,1) = {"
a
a
a
a
a
a
a
a
a
a
a
a
a
a
a
a
a
a
a
a
a
a
a
a
a
a
a
a
a
a
a
a
"}
(41,1,1) = {"
a
a
a
a
a
a
a
a
a
a
a
a
a
a
a
a
a
a
a
a
a
a
a
a
a
a
a
a
a
a
a
a
"}
(42,1,1) = {"
a
a
a
a
a
a
a
a
a
a
a
a
a
a
a
a
a
a
a
a
a
a
a
a
a
a
a
a
a
a
a
a
"}
(43,1,1) = {"
a
a
a
a
a
a
a
a
a
a
a
a
a
a
a
a
a
a
a
a
a
a
a
a
a
a
a
a
a
a
a
a
"}
(44,1,1) = {"
a
a
a
a
a
a
a
a
a
a
a
a
a
a
a
a
a
a
a
a
a
a
a
a
a
a
a
a
a
a
a
a
"}
(45,1,1) = {"
a
a
a
a
a
a
a
a
a
a
a
a
a
a
a
a
a
a
a
a
a
a
a
a
a
a
a
a
a
a
a
a
"}
(46,1,1) = {"
a
a
a
a
a
a
a
a
a
a
a
a
a
a
a
a
a
a
a
a
a
a
a
a
a
a
a
a
a
a
a
a
"}
(47,1,1) = {"
a
a
a
a
a
a
a
a
a
a
a
a
a
a
a
a
a
a
a
a
a
a
a
a
a
a
a
a
a
a
a
a
"}
(48,1,1) = {"
a
a
a
a
a
a
a
a
a
a
a
a
a
a
a
a
a
a
a
a
a
a
a
a
a
a
a
a
a
a
a
a
"}
