//MAP CONVERTED BY dmm2tgm.py THIS HEADER COMMENT PREVENTS RECONVERSION, DO NOT REMOVE
"a" = (
/turf/open,
/area/valSal_port/outside/outdoors_mtn_top)
"b" = (
/turf/wall/natural/random/basalt/valSal_port,
/area/valSal_port/outside/outdoors_mtn_top)
"d" = (
/obj/structure/fire_source/firepit/basalt,
/obj/item/stack/material/log/mapped/maple/five,
/turf/floor/barren,
/area/valSal_port/outside/outdoors_mtn_top)
"f" = (
/obj/item/flame/match,
/obj/item/flame/match,
/turf/floor/barren,
/area/valSal_port/outside/outdoors_mtn_top)
"i" = (
/obj/abstract/map_data/valSal_port,
/turf/unsimulated/dark_filler,
/area/valSal_port/outside/outdoors_mtn_top)
"l" = (
/turf/floor/rock/basalt,
/area/valSal_port/outside/outdoors_mtn_top)
"m" = (
/obj/item/tool/axe/iron,
/turf/floor/barren,
/area/valSal_port/outside/outdoors_mtn_top)
"p" = (
/obj/item/flame/match,
/turf/floor/barren,
/area/valSal_port/outside/outdoors_mtn_top)
"w" = (
/turf/floor/barren,
/area/valSal_port/outside/outdoors_mtn_top)
"y" = (
/obj/structure/flora/tree/hardwood/ebony,
/turf/unsimulated/dark_filler,
/area/valSal_port/outside/outdoors_mtn_top)
"C" = (
/obj/item/remains/human,
/obj/item/clothing/suit/mantle/fated,
/obj/item/clothing/head/santahat{
	name = "Iceman's hat";
	desc = "A pointed hat with a furred rim designed to keep the head warm."
	},
/turf/floor/barren,
/area/valSal_port/outside/outdoors_mtn_top)
"E" = (
/turf/floor/path/running_bond/basalt,
/area/valSal_port/outside/outdoors_mtn_top)
"F" = (
/mob/living/simple_animal/passive/mouse/snaprat,
/turf/floor/snow,
/area/valSal_port/outside/outdoors_mtn_top)
"J" = (
/turf/floor/snow,
/area/valSal_port/outside/outdoors_mtn_top)
"K" = (
/obj/abstract/level_data_spawner/valSal_port_mtntop,
/turf/unsimulated/dark_filler,
/area/valSal_port/outside/outdoors_mtn_top)
"M" = (
/obj/item/remains/mouse,
/turf/floor/barren,
/area/valSal_port/outside/outdoors_mtn_top)
"N" = (
/turf/wall/natural/basalt/valSal_port,
/area/valSal_port/outside/outdoors_mtn_top)
"R" = (
/mob/living/simple_animal/passive/mouse/snaprat,
/turf/floor/barren,
/area/valSal_port/outside/outdoors_mtn_top)
"T" = (
/obj/structure/boulder/basalt,
/turf/floor/rock/basalt,
/area/valSal_port/outside/outdoors_mtn_top)
"W" = (
/turf/unsimulated/dark_filler,
/area/valSal_port/outside/outdoors_mtn_top)
"Z" = (
/turf/floor/straw,
/area/valSal_port/outside/outdoors_mtn_top)

(1,1,1) = {"
W
W
W
W
W
W
W
W
W
W
W
W
W
W
W
W
W
W
W
W
W
W
W
W
W
W
W
W
W
W
W
W
W
W
W
W
W
W
W
W
W
W
W
W
W
W
W
W
W
W
W
W
W
W
W
W
W
W
W
W
W
W
W
W
W
W
W
W
W
W
W
W
W
W
W
W
W
W
W
W
W
W
W
W
W
W
W
W
W
W
W
W
W
W
W
W
W
W
W
W
"}
(2,1,1) = {"
W
W
W
W
W
W
W
W
W
W
W
W
W
W
W
W
W
W
W
W
W
W
W
W
W
W
W
W
W
W
W
W
W
W
W
W
W
W
W
W
W
W
W
W
W
W
W
W
W
W
W
W
W
W
W
W
W
W
W
W
W
W
W
W
W
W
W
W
W
W
W
W
W
W
W
W
W
W
W
W
W
W
W
W
W
W
W
W
W
W
W
W
W
W
W
W
W
W
W
W
"}
(3,1,1) = {"
W
W
W
W
W
W
W
W
W
W
W
W
W
W
W
W
W
W
W
W
W
W
W
W
W
W
W
W
W
W
W
W
W
W
W
W
W
W
W
W
W
W
W
W
W
W
W
W
W
W
W
W
W
W
W
W
W
W
W
W
W
W
W
W
W
W
W
W
W
W
W
W
W
W
W
W
W
W
W
W
W
W
W
W
W
W
W
W
W
W
W
W
W
W
W
W
W
W
W
W
"}
(4,1,1) = {"
W
W
W
W
W
W
W
W
W
W
W
W
W
W
W
W
W
W
W
W
W
W
W
W
W
W
W
W
W
W
W
W
W
W
W
W
W
W
W
W
W
W
W
W
W
W
W
W
W
W
W
W
W
W
W
W
W
W
W
W
W
W
W
W
W
W
W
W
W
W
W
W
W
W
W
W
W
W
W
W
W
W
W
W
W
W
W
W
W
W
W
W
W
W
W
W
W
W
W
W
"}
(5,1,1) = {"
W
W
W
W
W
W
W
W
W
W
W
W
W
W
W
W
W
W
W
W
W
W
W
W
W
W
W
W
W
W
W
W
W
W
W
W
W
W
W
W
W
W
W
W
W
W
W
W
W
W
W
W
W
W
W
W
W
W
W
W
W
W
W
W
W
W
W
W
W
W
W
W
W
W
W
W
W
W
W
W
W
W
W
W
W
W
W
W
W
W
W
W
W
W
W
W
W
W
W
W
"}
(6,1,1) = {"
W
W
W
W
W
W
W
W
W
W
W
W
W
W
W
W
W
W
W
W
W
W
W
W
W
W
W
W
W
W
W
W
W
W
W
W
W
W
W
W
W
W
W
W
W
W
W
W
W
W
W
W
W
W
W
W
W
W
W
W
W
W
W
W
W
W
W
W
W
W
W
W
W
W
W
W
W
W
W
W
W
W
W
W
W
W
W
W
W
W
W
W
W
W
W
W
W
W
W
W
"}
(7,1,1) = {"
W
W
W
W
W
W
W
W
W
W
W
W
W
W
W
W
W
W
W
W
W
W
W
W
W
W
W
W
W
W
W
W
W
W
W
W
W
W
W
W
W
W
W
W
W
W
W
W
W
W
W
W
W
W
W
W
W
W
W
W
W
W
W
W
W
W
W
W
W
W
W
W
W
W
W
W
W
W
W
W
W
W
W
W
W
W
W
W
W
W
W
W
W
W
W
W
W
W
W
W
"}
(8,1,1) = {"
N
N
N
N
N
N
N
N
N
N
N
N
N
N
N
N
N
N
N
N
N
N
N
N
N
N
N
N
N
N
N
N
N
N
N
N
N
N
N
N
N
N
N
N
N
N
N
J
w
J
w
J
N
N
N
N
N
N
N
N
N
N
N
N
N
N
N
N
N
N
N
N
N
N
N
N
N
N
N
N
N
N
N
N
N
N
N
N
N
N
N
N
N
N
N
N
N
N
N
N
"}
(9,1,1) = {"
N
N
N
N
N
N
N
N
N
N
N
N
N
N
N
N
N
N
N
N
N
N
N
N
N
N
N
N
N
N
N
N
N
N
N
N
N
N
N
N
N
N
N
N
N
N
N
J
J
w
J
J
N
N
N
N
N
N
N
N
N
N
N
N
N
N
N
N
N
N
N
N
N
N
N
N
N
N
N
N
N
N
N
N
N
N
N
N
N
N
N
N
N
N
N
N
N
N
N
N
"}
(10,1,1) = {"
N
N
N
N
N
N
N
N
N
N
N
N
N
N
N
N
N
N
N
N
N
N
N
N
N
N
N
N
N
N
N
N
N
N
N
N
N
N
N
N
N
N
N
N
N
N
N
J
J
w
J
J
N
N
N
N
N
N
N
N
N
N
N
N
N
N
N
N
N
N
N
N
N
N
N
N
N
N
N
N
N
N
N
J
J
J
J
J
N
N
N
N
N
N
N
N
N
N
N
N
"}
(11,1,1) = {"
N
N
N
N
N
N
N
N
N
N
N
N
N
N
N
N
N
N
N
N
N
N
N
N
N
N
N
N
N
N
N
N
N
N
N
J
J
N
N
N
N
N
N
N
N
N
l
J
w
w
J
J
N
N
N
N
N
N
N
N
N
N
N
N
N
N
N
N
N
N
N
N
N
N
N
N
N
N
N
N
J
J
J
J
J
J
J
J
J
J
J
N
N
N
N
N
N
N
N
N
"}
(12,1,1) = {"
N
N
N
N
N
N
N
N
N
N
N
N
N
N
N
N
N
N
N
N
N
N
N
N
N
N
N
N
N
N
N
N
N
N
J
J
J
J
J
N
N
N
N
N
J
J
J
J
w
w
J
J
J
N
N
N
N
N
N
N
N
N
N
N
N
N
N
N
N
N
N
N
N
N
N
N
N
N
J
J
J
J
J
w
J
w
w
J
J
J
J
J
J
J
N
N
N
N
N
N
"}
(13,1,1) = {"
N
N
N
N
N
N
N
N
N
N
N
N
N
N
J
J
J
J
J
J
N
N
N
N
N
N
N
N
N
N
N
N
N
J
J
J
J
J
J
J
J
J
J
J
J
J
J
J
w
w
w
J
J
J
J
J
N
N
N
N
N
N
N
N
J
J
J
J
J
J
N
N
N
N
N
J
J
J
J
w
w
w
w
w
w
w
w
w
w
J
J
J
J
J
J
J
J
J
N
N
"}
(14,1,1) = {"
N
N
N
N
N
N
N
N
N
N
J
J
J
J
J
J
J
N
N
J
J
J
J
N
N
N
N
N
N
N
N
N
N
J
J
w
w
w
w
J
J
J
w
w
w
w
w
J
w
T
w
w
w
J
J
J
J
J
J
N
N
J
J
J
J
J
J
J
w
J
J
J
J
J
J
J
J
J
w
w
T
l
l
l
w
l
l
l
w
w
w
J
J
w
w
J
J
J
J
N
"}
(15,1,1) = {"
N
N
N
N
N
N
N
N
N
J
J
J
J
w
w
J
J
N
N
N
N
J
J
J
J
J
N
N
N
N
N
N
N
J
J
J
w
l
w
w
w
J
w
l
l
l
w
w
w
l
l
l
w
w
w
J
w
J
J
J
J
J
J
J
J
J
w
w
w
w
w
w
J
J
J
w
w
w
w
l
l
l
l
l
l
l
l
l
l
l
w
w
w
w
w
w
w
J
J
J
"}
(16,1,1) = {"
N
N
N
N
N
N
N
N
N
J
J
J
w
w
w
w
J
J
N
N
N
N
N
J
J
J
J
J
N
N
N
N
J
J
J
w
w
l
l
l
w
w
w
l
l
l
l
w
l
l
l
l
l
l
w
w
J
w
w
J
w
w
w
w
w
w
w
l
l
w
J
J
J
l
l
l
l
l
l
l
l
l
l
T
l
l
T
l
l
l
l
l
l
l
l
w
J
w
w
J
"}
(17,1,1) = {"
N
N
N
N
N
N
N
N
J
J
R
w
p
C
m
w
w
J
N
N
N
N
N
N
N
J
J
J
J
N
N
N
J
J
J
w
l
l
l
l
l
w
l
l
l
l
l
l
l
l
l
l
l
l
l
l
w
J
l
l
l
l
l
l
l
l
l
l
l
l
l
l
l
a
a
a
a
a
a
a
a
l
l
l
l
l
l
l
l
l
l
T
l
l
l
w
w
w
J
w
"}
(18,1,1) = {"
N
N
N
N
N
N
N
N
J
w
w
w
f
d
p
R
J
J
N
N
N
N
N
N
N
N
N
J
J
J
N
J
J
J
w
w
l
l
T
l
l
l
l
l
l
l
l
l
l
l
T
l
l
l
l
l
l
l
l
l
l
l
l
l
l
l
l
l
l
l
a
a
a
a
a
a
a
a
a
a
a
a
a
a
a
a
l
l
l
l
l
l
l
l
l
l
l
l
w
w
"}
(19,1,1) = {"
N
N
N
N
N
N
N
N
J
J
w
M
w
w
w
w
J
J
N
N
N
N
N
N
N
N
N
N
J
J
J
J
w
J
w
l
l
l
l
l
l
l
l
l
l
l
l
l
l
l
l
l
l
l
l
l
l
l
l
T
l
l
l
l
l
l
l
l
a
a
a
a
a
a
a
a
a
a
a
a
a
a
a
a
a
a
a
l
l
l
l
l
l
l
l
l
l
l
l
w
"}
(20,1,1) = {"
N
N
N
N
N
N
N
N
N
J
J
w
w
w
w
J
J
N
N
N
N
N
N
N
N
N
N
J
J
J
J
w
J
w
w
l
l
l
l
l
l
l
l
l
l
l
l
l
l
l
l
l
l
l
l
l
l
l
l
l
l
l
l
l
l
l
l
a
a
a
a
a
a
a
a
a
a
a
a
a
a
a
a
a
a
a
a
a
a
l
l
l
l
l
l
l
T
l
l
w
"}
(21,1,1) = {"
N
N
N
N
N
N
N
N
N
J
J
J
J
F
J
J
J
N
N
N
N
N
N
N
J
J
J
J
J
J
w
w
J
w
l
l
l
l
l
l
l
l
l
l
l
l
l
l
l
l
l
l
l
l
l
l
l
l
l
l
l
l
l
l
l
a
a
a
a
a
a
a
a
a
a
a
a
a
a
a
a
a
a
a
a
a
a
a
a
a
l
l
l
l
l
l
l
l
l
l
"}
(22,1,1) = {"
N
N
N
N
N
N
N
N
N
N
N
J
J
J
J
N
N
N
N
N
N
N
N
J
J
J
J
w
J
w
w
w
l
l
l
l
l
l
l
l
l
l
T
l
l
l
T
l
l
l
l
l
l
l
l
l
l
l
l
l
l
l
l
a
a
a
a
a
a
a
a
a
a
a
a
a
a
a
a
a
a
a
a
a
a
a
a
a
a
a
a
l
l
l
T
l
l
l
l
l
"}
(23,1,1) = {"
N
N
N
N
N
N
N
N
N
N
N
N
N
N
N
N
N
N
N
N
N
N
J
J
J
w
w
w
w
w
l
J
l
l
l
l
l
l
l
l
l
l
l
l
l
l
l
l
l
l
l
l
l
T
l
l
l
l
l
l
a
a
a
a
a
a
a
a
a
a
a
a
a
a
a
a
a
a
a
a
l
a
a
a
a
a
a
a
a
a
a
a
a
l
l
l
l
l
l
a
"}
(24,1,1) = {"
N
N
N
N
N
N
N
N
N
N
N
N
N
N
N
N
N
N
N
N
N
J
J
w
J
w
l
l
w
l
l
l
l
l
l
l
l
l
l
l
l
l
l
l
l
l
l
l
l
l
l
l
l
l
l
l
l
l
a
a
a
a
a
a
a
a
a
a
a
a
a
a
a
a
a
a
a
a
a
a
l
l
l
a
a
a
a
a
a
a
a
a
a
a
a
l
l
a
a
a
"}
(25,1,1) = {"
N
N
N
N
N
N
N
N
N
N
N
N
N
N
N
N
N
J
J
J
J
J
J
J
w
w
l
l
l
l
l
l
l
l
l
l
l
l
T
l
l
l
l
l
l
l
l
l
l
l
l
l
l
l
l
l
a
a
a
a
a
a
a
a
a
a
a
a
a
a
a
a
a
a
a
a
a
a
a
a
a
l
T
a
a
a
a
a
a
a
a
a
a
a
a
a
a
a
a
a
"}
(26,1,1) = {"
N
N
N
N
N
N
N
N
N
N
N
N
N
N
a
J
J
J
J
J
J
J
J
w
w
l
l
l
l
l
l
T
l
l
l
l
l
l
l
l
l
l
l
l
l
l
l
l
l
l
l
l
l
l
a
a
a
a
a
a
a
a
a
a
a
a
a
a
a
a
a
a
a
a
a
a
a
a
a
a
a
a
l
a
a
a
a
a
a
a
a
a
a
a
a
a
a
a
a
a
"}
(27,1,1) = {"
N
N
N
N
N
N
N
N
N
N
N
N
N
J
a
J
J
w
w
w
w
w
J
w
l
l
T
l
l
l
l
l
l
l
l
l
l
l
l
l
l
l
l
Z
Z
Z
Z
Z
Z
a
a
a
a
a
a
a
a
a
a
a
a
a
a
a
a
a
a
a
a
a
a
a
a
a
a
a
a
a
a
a
a
a
a
a
a
Z
Z
Z
Z
Z
Z
Z
a
a
a
a
a
a
a
a
"}
(28,1,1) = {"
N
N
N
N
N
N
N
N
N
N
N
N
J
J
J
w
w
J
w
l
l
l
w
l
l
l
l
l
l
l
l
l
l
l
a
a
a
a
Z
Z
Z
Z
Z
Z
Z
Z
Z
Z
Z
a
a
a
a
a
a
a
a
a
a
a
a
a
a
a
a
a
a
a
a
a
a
a
a
a
a
a
a
a
a
a
a
a
a
a
Z
Z
Z
Z
Z
Z
Z
Z
Z
a
a
a
a
a
a
a
"}
(29,1,1) = {"
N
N
N
N
N
N
N
N
l
N
N
J
J
J
J
J
J
J
w
l
l
l
l
l
l
l
l
l
a
a
a
a
a
a
a
a
a
a
Z
Z
Z
Z
Z
Z
Z
Z
Z
Z
Z
a
a
a
a
a
a
a
a
a
a
a
a
a
a
a
a
a
a
a
a
a
a
a
a
a
a
a
a
a
a
a
a
a
a
a
Z
Z
Z
Z
Z
Z
Z
Z
Z
a
a
a
a
a
a
a
"}
(30,1,1) = {"
N
N
N
N
J
J
J
N
N
J
J
J
J
J
w
w
w
w
w
l
l
l
l
l
l
a
a
a
a
a
a
a
a
a
a
a
a
a
Z
Z
Z
Z
Z
Z
Z
Z
Z
Z
Z
a
a
a
a
a
a
a
a
a
a
a
a
a
a
a
a
a
a
a
a
a
a
a
a
a
a
a
a
a
a
a
a
a
a
a
Z
Z
Z
Z
Z
Z
Z
Z
Z
a
l
l
l
a
a
a
"}
(31,1,1) = {"
N
N
N
J
J
J
J
J
J
J
J
J
w
w
w
w
l
l
l
l
l
l
l
a
a
a
a
a
a
a
a
a
a
a
a
a
a
a
Z
Z
Z
Z
Z
Z
Z
Z
Z
Z
Z
a
a
a
a
a
a
a
a
a
a
a
a
a
a
a
a
a
a
a
a
a
a
a
a
a
a
a
a
a
a
a
a
a
a
a
a
Z
Z
Z
Z
Z
Z
Z
a
a
T
l
a
a
a
a
"}
(32,1,1) = {"
N
N
J
J
w
w
J
J
w
w
w
w
w
l
l
l
l
l
l
T
l
l
a
a
a
a
a
a
a
a
a
a
a
a
a
a
a
a
Z
Z
Z
Z
Z
Z
Z
Z
Z
Z
Z
a
a
a
a
a
a
a
a
a
a
a
a
a
a
a
a
a
a
a
a
a
a
a
a
a
a
a
a
a
a
a
a
a
a
a
a
a
a
Z
Z
Z
a
a
a
a
l
l
a
a
a
a
"}
(33,1,1) = {"
N
N
J
w
w
J
w
w
w
w
l
l
l
l
l
l
l
l
l
l
l
a
a
a
a
a
a
a
a
a
a
a
a
a
a
a
a
a
a
a
a
a
a
a
a
a
a
a
a
a
a
a
a
a
a
a
a
a
a
a
a
a
a
a
a
a
a
a
a
a
a
a
a
a
a
a
a
a
a
a
a
a
a
a
a
a
a
Z
Z
Z
a
a
a
a
a
a
a
a
a
a
"}
(34,1,1) = {"
N
N
J
w
w
w
w
l
l
l
l
l
l
l
l
l
l
l
l
l
a
a
a
a
a
a
a
a
a
a
a
a
a
a
a
a
a
a
a
a
a
a
a
a
a
a
a
a
a
a
a
a
a
a
a
a
a
a
a
a
a
a
a
a
a
a
a
a
a
a
a
a
a
a
a
a
a
a
a
a
a
a
a
a
a
Z
Z
Z
Z
Z
Z
Z
a
a
a
a
a
a
a
a
"}
(35,1,1) = {"
N
N
J
J
w
w
l
l
l
l
l
l
l
l
l
l
l
l
l
a
a
a
a
a
a
a
a
a
a
a
a
a
a
a
a
l
l
a
a
a
a
a
a
a
a
a
a
a
a
a
a
a
a
a
a
a
a
a
a
a
a
a
a
a
a
a
a
a
a
a
a
a
a
a
a
a
a
a
a
a
a
a
a
a
a
Z
Z
Z
Z
Z
Z
Z
a
a
a
a
a
a
a
a
"}
(36,1,1) = {"
N
N
N
J
J
w
w
l
l
l
l
l
l
l
l
l
l
l
a
a
a
a
a
a
a
a
a
a
a
a
a
a
a
a
l
l
l
a
a
a
a
a
a
a
a
a
a
a
a
a
a
a
a
a
a
a
a
a
a
a
a
a
a
a
a
a
a
a
a
a
a
a
a
a
a
a
a
a
a
a
a
a
a
a
a
Z
Z
Z
Z
Z
Z
Z
a
a
a
a
a
a
a
a
"}
(37,1,1) = {"
N
N
N
N
J
J
w
w
l
l
l
l
l
l
l
l
l
a
a
a
a
a
a
a
a
a
a
a
a
a
a
a
a
l
l
l
a
a
a
a
a
a
a
a
a
a
a
a
a
a
a
a
a
a
a
a
a
a
a
a
a
a
a
a
a
a
a
a
a
a
a
a
a
a
a
a
a
a
a
a
a
a
a
a
a
Z
Z
Z
Z
Z
Z
Z
a
a
a
a
a
a
a
a
"}
(38,1,1) = {"
N
N
N
N
J
J
J
w
w
l
l
T
l
l
l
l
a
a
a
a
a
a
a
a
a
a
a
a
a
a
a
a
a
l
l
l
a
a
a
a
a
a
a
a
a
a
a
a
a
a
a
a
a
a
a
a
a
a
a
a
a
a
a
a
a
a
a
a
a
a
a
a
a
a
a
a
a
a
a
a
a
a
a
a
a
Z
Z
Z
Z
Z
Z
Z
a
a
a
a
a
a
a
a
"}
(39,1,1) = {"
N
N
N
N
N
J
w
w
l
l
l
l
l
l
l
l
a
a
a
a
a
a
a
a
a
a
a
a
a
a
a
a
a
a
a
a
a
a
a
a
a
a
a
a
a
a
a
a
a
a
a
a
a
a
a
a
a
a
a
a
a
a
a
a
a
a
a
a
a
a
a
a
a
a
a
a
a
a
a
a
a
a
a
a
a
Z
a
Z
a
Z
a
Z
a
a
a
a
a
a
a
a
"}
(40,1,1) = {"
N
N
N
N
N
J
J
w
l
l
l
l
l
l
l
a
a
a
a
a
a
a
a
a
a
a
a
a
a
a
a
a
a
a
a
a
a
a
a
a
a
a
a
a
a
a
a
a
a
a
a
a
a
a
a
a
a
a
a
a
a
a
a
a
a
a
a
a
a
a
a
a
a
a
a
a
a
a
a
a
a
a
a
a
a
a
a
a
a
a
a
a
a
a
a
a
a
a
a
a
"}
(41,1,1) = {"
N
N
N
N
N
N
J
w
w
l
l
l
l
l
l
a
a
a
a
a
a
a
a
a
a
a
a
a
a
a
a
a
a
a
a
a
a
a
a
a
a
a
a
a
a
a
a
a
a
a
a
a
a
a
a
a
a
a
a
a
a
a
a
a
a
a
a
a
a
a
a
a
a
a
a
a
a
a
a
a
a
a
a
a
a
a
a
a
a
a
a
a
a
a
a
a
a
a
a
a
"}
(42,1,1) = {"
N
N
N
N
N
N
J
J
w
l
l
l
l
l
a
a
a
a
a
a
a
a
a
a
a
a
a
a
a
a
a
a
a
a
a
a
a
a
a
a
a
a
a
a
a
a
a
a
a
a
a
a
a
a
a
a
a
a
a
a
a
a
a
a
a
a
a
a
a
a
a
a
a
a
a
a
a
a
a
a
a
a
a
a
a
a
a
a
a
a
a
a
a
a
a
a
a
a
a
a
"}
(43,1,1) = {"
N
N
N
N
N
N
J
J
w
l
l
l
l
l
a
a
a
a
a
a
a
a
a
a
a
a
a
a
a
a
a
a
a
a
a
a
a
a
a
a
a
a
a
a
a
a
a
a
a
a
a
a
a
a
a
a
a
a
a
a
a
a
a
a
a
a
a
a
a
a
a
a
a
a
a
a
a
a
a
a
a
a
a
a
a
a
a
a
a
a
a
a
a
a
a
a
a
a
a
a
"}
(44,1,1) = {"
N
N
N
N
N
N
J
J
w
w
l
l
l
l
a
a
a
a
a
a
a
a
a
a
a
a
a
a
a
a
a
a
a
a
a
a
a
a
a
a
a
a
a
a
a
a
a
a
a
a
a
a
a
a
a
a
a
a
a
a
a
a
a
a
a
a
a
a
a
a
a
a
a
a
a
a
a
a
a
a
a
a
a
a
a
a
a
a
a
a
a
a
a
a
a
a
a
a
a
a
"}
(45,1,1) = {"
N
N
N
N
N
N
J
J
J
w
l
T
l
a
a
a
a
l
l
l
a
a
a
a
a
a
a
a
a
a
a
a
a
a
a
a
a
a
a
a
a
a
a
a
a
a
a
a
a
a
a
a
a
a
a
a
a
a
a
a
a
a
a
a
a
a
a
a
a
a
a
a
a
a
a
a
a
a
a
a
a
a
a
a
a
a
a
a
a
a
a
a
a
a
a
a
a
a
a
a
"}
(46,1,1) = {"
N
N
N
N
N
N
J
J
J
w
w
l
l
a
a
a
a
l
l
l
l
a
a
a
a
a
a
a
a
a
a
a
a
a
a
a
a
a
a
a
a
a
a
a
a
a
a
a
a
a
a
a
a
a
a
a
a
a
a
a
a
a
a
a
a
a
a
a
a
a
a
a
a
a
a
a
a
a
a
a
a
a
a
a
a
a
a
a
a
a
a
a
a
a
a
a
a
a
a
a
"}
(47,1,1) = {"
N
N
N
N
N
N
J
J
w
J
w
l
l
a
a
a
a
a
a
a
a
a
a
a
a
a
a
a
a
a
a
a
a
a
a
a
a
a
a
a
a
a
a
a
a
a
a
a
a
a
a
a
a
a
a
a
a
a
a
a
a
a
a
a
a
a
a
a
a
a
a
a
a
a
a
a
a
a
a
a
a
a
a
a
a
a
a
a
a
a
a
a
a
a
a
a
a
a
a
a
"}
(48,1,1) = {"
N
N
N
N
N
N
J
J
w
J
w
l
l
a
a
a
a
a
a
a
a
a
a
a
a
a
a
a
a
a
a
a
a
a
a
a
a
a
a
a
a
a
a
a
a
a
a
a
a
a
Z
Z
Z
Z
Z
Z
Z
Z
Z
a
a
a
a
a
a
a
a
a
a
a
a
a
a
a
a
a
a
a
a
a
a
a
a
a
a
a
a
a
a
a
a
a
a
a
a
a
a
a
a
a
"}
(49,1,1) = {"
N
N
N
N
N
N
J
w
w
w
w
l
l
a
a
a
a
a
a
a
a
a
a
a
a
a
a
a
a
a
a
a
a
a
a
a
a
a
a
a
a
a
a
a
a
a
a
a
a
a
Z
Z
Z
Z
Z
Z
Z
Z
Z
a
a
a
a
a
a
a
a
a
a
a
a
a
a
a
a
a
a
a
a
a
a
a
a
a
a
a
a
a
a
a
a
a
a
a
a
a
a
a
a
a
"}
(50,1,1) = {"
N
N
N
N
N
J
J
w
l
w
w
l
a
a
a
a
a
a
a
a
a
a
a
a
a
a
a
a
a
a
a
a
a
a
a
a
a
a
a
a
a
a
a
a
a
a
a
a
a
a
Z
Z
Z
Z
Z
Z
Z
Z
Z
a
a
a
a
a
a
a
a
a
a
a
a
a
a
a
a
a
a
a
a
a
a
a
a
a
a
a
a
a
a
a
a
a
a
a
a
a
a
a
a
a
"}
(51,1,1) = {"
N
N
N
N
N
J
J
w
l
w
l
l
a
a
a
a
a
a
a
a
a
a
a
a
a
a
a
a
a
a
a
a
a
a
a
a
a
a
a
a
a
a
a
a
a
a
a
a
a
a
Z
Z
Z
Z
Z
Z
Z
Z
Z
a
a
a
a
a
a
a
a
a
a
a
a
a
a
a
a
a
a
a
a
a
a
a
a
a
a
a
a
a
a
a
a
a
a
a
a
a
a
a
a
a
"}
(52,1,1) = {"
N
N
N
N
N
J
J
w
l
l
l
l
a
a
a
a
a
a
a
a
a
a
a
a
a
a
a
a
a
a
a
a
a
a
a
a
a
a
a
a
a
a
a
a
a
a
a
a
a
a
Z
Z
Z
Z
Z
Z
Z
Z
Z
a
a
a
a
a
a
a
a
a
a
a
a
a
a
a
a
a
a
a
a
a
a
a
a
a
a
a
a
a
a
a
a
a
a
a
a
a
a
a
a
a
"}
(53,1,1) = {"
N
N
N
N
N
J
J
w
l
l
l
a
a
a
a
a
a
a
a
a
a
a
a
a
a
a
a
a
a
a
a
a
a
a
a
a
a
a
a
a
a
a
a
a
a
a
a
a
a
a
a
Z
Z
Z
Z
Z
Z
Z
a
a
a
a
a
a
a
a
a
a
a
a
a
a
a
a
a
a
a
a
a
a
a
a
a
a
a
a
a
a
a
a
a
a
a
a
a
a
a
a
a
a
"}
(54,1,1) = {"
N
N
N
N
N
J
J
w
T
l
l
a
a
a
a
a
a
a
a
a
a
a
a
a
a
a
a
a
a
a
a
a
a
a
a
a
a
a
a
a
a
a
a
a
a
a
a
a
a
a
Z
Z
Z
Z
Z
Z
Z
Z
Z
a
a
a
a
a
a
a
a
a
a
a
a
a
a
a
a
a
a
a
a
a
a
a
a
a
a
a
a
a
a
a
a
a
a
a
a
a
a
a
a
a
"}
(55,1,1) = {"
N
N
N
N
N
J
J
w
l
l
l
a
a
a
a
a
a
a
a
a
a
a
a
a
a
a
a
a
a
a
a
a
a
a
a
a
a
a
a
a
a
a
a
a
a
a
a
a
a
a
Z
Z
Z
Z
Z
Z
Z
Z
Z
a
a
a
a
a
a
a
a
a
a
a
a
a
a
a
a
a
a
a
a
a
a
a
a
a
a
a
a
a
a
a
a
a
a
a
a
a
a
a
a
a
"}
(56,1,1) = {"
N
N
N
N
J
J
J
w
l
l
a
a
a
a
a
a
a
a
a
a
a
a
a
a
a
a
a
a
a
a
a
l
a
a
a
a
a
a
a
a
a
l
l
l
l
a
a
a
a
a
Z
Z
Z
Z
Z
Z
Z
Z
Z
a
a
a
a
a
a
Z
Z
Z
Z
Z
a
a
a
a
a
a
a
a
a
a
a
a
a
a
a
a
a
a
a
a
a
a
a
a
a
a
a
a
a
a
"}
(57,1,1) = {"
N
N
N
N
J
w
J
w
l
l
a
a
a
a
a
a
a
a
a
a
a
a
a
a
a
a
a
a
a
l
l
T
l
a
a
a
a
a
a
a
a
a
l
l
a
a
a
a
a
a
Z
Z
Z
Z
Z
Z
Z
Z
Z
a
a
a
a
a
a
Z
Z
Z
Z
Z
a
a
a
a
a
a
a
a
a
a
a
a
a
a
a
a
a
a
a
a
a
a
a
a
a
a
a
a
a
a
"}
(58,1,1) = {"
N
N
N
J
J
w
J
w
l
l
a
a
a
a
a
a
a
a
a
a
a
a
a
a
a
a
a
a
a
l
l
a
l
l
a
a
a
a
a
a
a
a
a
a
a
a
a
a
a
a
Z
Z
Z
Z
Z
Z
Z
Z
Z
a
a
a
a
a
Z
Z
Z
Z
Z
Z
Z
a
a
a
a
a
a
a
a
a
a
a
a
a
a
a
a
a
a
a
a
a
a
a
a
a
a
a
a
a
"}
(59,1,1) = {"
N
N
N
J
w
J
w
w
l
a
a
a
a
a
a
a
a
a
a
a
a
a
a
a
a
a
a
a
a
a
a
a
a
a
a
a
a
a
a
a
a
a
a
a
a
a
a
a
a
a
a
a
a
a
a
a
a
a
a
a
a
a
a
a
Z
Z
Z
Z
Z
Z
Z
a
a
a
a
a
a
a
a
a
a
a
a
a
a
a
a
Z
Z
Z
Z
Z
a
a
a
a
a
a
a
a
"}
(60,1,1) = {"
N
N
J
J
w
J
w
l
l
a
a
a
a
a
a
a
a
a
a
a
a
a
a
a
a
a
a
a
a
a
a
a
a
a
a
a
a
a
a
a
a
a
a
a
a
a
a
a
a
a
a
a
a
a
a
a
a
a
a
a
a
a
a
a
Z
Z
Z
Z
Z
Z
Z
a
a
a
a
a
a
a
a
a
a
a
a
a
a
a
Z
Z
Z
Z
Z
Z
Z
a
a
a
a
a
a
a
"}
(61,1,1) = {"
N
N
J
w
w
J
w
l
l
a
a
a
a
a
a
a
a
a
a
a
a
a
a
a
a
a
a
a
a
a
a
a
a
a
a
a
a
a
a
a
a
a
a
a
Z
Z
Z
Z
Z
Z
Z
Z
Z
Z
Z
Z
a
a
a
a
a
a
a
a
Z
Z
Z
Z
Z
Z
Z
a
a
a
a
a
a
a
a
a
a
a
a
a
a
a
Z
Z
Z
Z
Z
Z
Z
a
a
a
a
a
a
a
"}
(62,1,1) = {"
N
N
J
w
w
w
w
l
a
a
a
a
a
a
a
a
a
a
a
a
a
a
a
a
a
a
a
a
a
a
a
a
a
a
a
a
a
a
a
a
a
a
a
a
Z
Z
Z
Z
Z
Z
Z
Z
Z
Z
Z
Z
Z
a
a
a
a
a
a
a
Z
Z
Z
Z
Z
Z
Z
a
a
a
a
a
a
a
a
a
a
a
a
a
a
a
Z
Z
Z
Z
Z
Z
Z
a
a
a
a
a
a
a
"}
(63,1,1) = {"
N
J
J
w
l
w
l
l
a
a
a
a
a
a
a
a
a
a
a
a
a
a
a
a
a
a
a
a
a
a
a
a
a
a
a
a
a
a
a
a
a
a
a
a
a
Z
Z
Z
Z
Z
Z
Z
Z
Z
Z
Z
Z
a
a
a
a
a
a
a
Z
Z
Z
Z
Z
Z
Z
a
a
a
a
a
a
a
a
a
a
a
a
a
a
a
Z
Z
Z
Z
Z
Z
Z
a
a
a
a
a
a
a
"}
(64,1,1) = {"
N
J
J
w
l
l
l
l
a
a
a
a
a
a
a
a
a
a
a
a
a
a
a
a
a
a
a
a
a
a
a
a
a
a
a
a
a
a
a
a
a
a
a
a
a
Z
Z
Z
Z
Z
Z
Z
Z
Z
Z
Z
Z
a
a
a
a
a
a
a
Z
Z
Z
Z
Z
Z
Z
a
a
a
a
a
a
a
a
a
a
a
a
a
a
a
Z
Z
Z
Z
Z
Z
Z
a
a
a
a
a
a
a
"}
(65,1,1) = {"
N
J
J
w
l
l
l
a
a
a
a
a
a
a
a
a
a
a
a
a
a
a
a
a
a
a
a
a
a
a
a
a
a
a
a
a
a
a
a
a
a
a
a
a
a
Z
Z
Z
Z
Z
Z
Z
Z
Z
Z
Z
Z
a
a
a
a
a
a
a
Z
Z
Z
Z
Z
Z
Z
a
a
a
a
a
a
a
a
a
a
a
a
a
a
Z
Z
Z
Z
Z
E
E
E
E
E
E
a
a
a
a
"}
(66,1,1) = {"
N
J
J
w
l
l
T
a
a
a
a
a
a
a
a
a
a
a
a
a
a
a
a
a
a
a
a
a
a
a
a
a
a
a
a
a
a
a
a
a
a
a
a
a
Z
Z
Z
Z
Z
Z
Z
Z
Z
Z
Z
Z
Z
a
a
a
a
a
a
a
a
Z
Z
Z
Z
Z
a
a
a
a
a
a
a
a
a
a
a
a
a
a
Z
Z
Z
Z
Z
Z
E
E
E
E
E
E
E
a
a
a
"}
(67,1,1) = {"
J
J
J
w
l
l
l
a
a
a
a
a
a
a
a
a
a
a
a
a
a
a
a
a
a
a
a
a
a
a
a
a
a
a
a
a
a
a
a
a
a
a
a
a
Z
Z
Z
Z
Z
Z
Z
Z
Z
Z
Z
Z
a
a
a
a
a
a
a
a
a
Z
Z
Z
Z
Z
a
a
a
a
a
a
a
a
a
a
a
a
a
a
Z
Z
Z
Z
Z
Z
E
E
E
E
E
E
E
a
a
a
"}
(68,1,1) = {"
J
J
w
J
w
l
a
a
a
a
a
a
a
a
a
a
a
a
a
a
a
a
a
a
a
a
a
a
a
a
a
a
a
a
a
a
a
a
a
a
a
a
a
a
a
a
a
a
a
a
a
a
a
a
a
a
a
a
a
a
a
a
a
a
a
a
a
a
a
a
a
a
a
a
a
a
a
a
a
a
a
a
a
a
Z
Z
Z
Z
Z
Z
E
E
E
E
E
E
E
a
a
a
"}
(69,1,1) = {"
J
l
l
w
l
l
a
a
a
a
a
a
a
a
a
a
a
a
a
a
a
a
a
a
a
a
a
N
l
a
a
a
a
a
a
a
a
a
a
a
a
a
a
a
a
a
a
a
a
a
a
a
a
a
a
a
a
a
a
a
a
a
a
a
a
a
a
a
a
a
a
a
a
a
a
a
a
a
a
a
a
a
a
a
Z
Z
Z
Z
Z
Z
E
E
E
E
E
E
E
a
a
a
"}
(70,1,1) = {"
T
l
l
l
l
l
a
a
a
a
a
a
a
a
a
a
a
a
a
a
a
a
a
a
a
l
N
b
l
a
a
a
a
a
a
a
a
a
a
a
a
a
a
a
a
a
a
a
a
a
Z
Z
Z
Z
Z
Z
Z
a
a
a
a
a
a
a
a
a
a
a
a
a
a
a
a
a
a
a
a
a
a
a
a
a
a
a
Z
Z
Z
Z
Z
Z
E
E
E
E
E
E
E
a
a
a
"}
(71,1,1) = {"
l
l
l
l
l
a
a
a
a
a
a
a
a
a
a
a
a
a
a
a
a
a
a
a
a
l
l
l
l
a
a
a
a
a
a
a
a
a
a
a
a
a
a
a
a
a
a
a
a
a
Z
Z
Z
Z
Z
Z
Z
a
a
a
a
a
a
a
a
a
a
a
a
a
a
a
a
a
a
a
a
a
a
a
a
a
a
a
a
Z
Z
Z
Z
Z
E
E
E
E
E
E
a
a
a
a
"}
(72,1,1) = {"
l
l
l
l
l
a
a
a
a
a
a
a
a
a
a
a
a
a
a
a
a
a
a
a
a
a
l
l
a
a
a
a
a
a
a
a
a
a
a
a
a
a
a
a
a
a
a
a
a
a
Z
Z
Z
Z
Z
Z
Z
a
a
a
a
a
a
a
a
a
a
a
a
a
a
a
a
a
a
a
a
a
a
a
a
a
a
a
a
a
Z
Z
Z
Z
Z
Z
Z
a
a
a
a
a
a
a
"}
(73,1,1) = {"
l
l
l
l
a
a
a
a
a
a
a
a
a
a
a
a
a
a
a
a
a
a
a
a
a
a
a
a
a
a
a
a
a
a
a
a
a
a
a
a
a
a
a
a
a
a
a
a
a
a
Z
Z
Z
Z
Z
Z
Z
a
a
a
a
a
a
a
a
a
a
a
a
a
a
a
a
a
a
a
a
a
a
a
a
a
a
a
a
a
Z
Z
Z
Z
Z
Z
Z
a
a
a
a
a
a
a
"}
(74,1,1) = {"
l
T
l
a
a
a
a
a
a
a
a
a
a
a
a
a
a
a
a
a
a
a
a
a
a
a
a
a
a
a
a
a
a
a
a
a
a
a
a
a
a
a
a
a
a
a
a
a
a
a
Z
Z
Z
Z
Z
Z
Z
a
a
a
a
a
a
a
a
a
a
a
a
a
a
a
a
a
a
a
a
a
a
a
a
a
a
a
a
a
Z
Z
Z
Z
Z
Z
Z
a
a
a
a
a
a
a
"}
(75,1,1) = {"
l
l
a
a
a
l
l
a
a
a
a
a
a
a
a
a
a
a
a
a
a
a
a
a
a
a
a
a
a
a
a
a
a
a
a
a
a
a
a
a
a
a
a
a
a
a
a
a
a
a
Z
Z
Z
Z
Z
Z
Z
a
a
a
a
a
a
a
a
a
a
a
a
a
a
a
a
a
a
a
a
a
a
a
a
a
a
a
a
a
Z
Z
Z
Z
Z
Z
Z
a
a
a
a
a
a
a
"}
(76,1,1) = {"
l
a
a
l
l
l
T
a
a
a
a
a
a
a
a
a
a
a
a
a
a
a
a
a
a
a
a
a
a
a
a
a
a
a
a
a
a
a
a
a
a
a
a
a
a
a
a
a
a
a
Z
Z
Z
Z
Z
Z
Z
a
a
a
a
a
a
a
a
a
a
a
a
a
a
a
a
a
a
a
a
a
a
a
a
a
a
a
a
a
Z
Z
Z
Z
Z
Z
Z
a
a
a
a
a
a
a
"}
(77,1,1) = {"
a
a
a
a
l
l
a
a
a
a
a
a
a
a
a
a
a
a
a
a
a
a
a
a
a
a
a
a
a
a
a
a
a
a
a
a
a
a
a
a
a
a
a
a
a
a
a
a
a
a
Z
Z
Z
Z
Z
Z
Z
a
a
a
a
a
a
a
a
a
a
a
a
a
a
a
a
a
a
a
a
a
a
a
a
a
a
a
a
a
a
Z
Z
Z
Z
Z
a
a
a
a
a
a
a
a
"}
(78,1,1) = {"
a
a
a
a
a
a
a
a
a
a
a
a
a
a
a
a
a
a
a
a
a
a
a
a
a
a
a
a
a
a
a
a
a
a
a
a
a
a
a
a
a
a
a
a
a
a
a
a
a
a
Z
Z
Z
Z
Z
Z
Z
a
a
a
a
a
a
a
a
a
a
a
a
a
a
a
a
a
a
a
a
a
a
a
a
a
a
a
a
a
a
a
a
a
a
a
a
a
a
a
a
a
a
a
"}
(79,1,1) = {"
a
a
a
a
a
a
a
a
a
a
a
a
a
a
a
a
a
a
a
a
a
a
a
a
a
a
a
a
a
a
a
a
a
a
a
a
a
a
a
a
a
a
a
a
a
a
a
a
a
a
a
a
a
a
a
a
a
a
a
a
a
a
a
a
a
a
a
a
a
a
a
a
a
a
a
a
a
a
a
a
a
a
a
a
a
a
a
a
a
a
a
a
a
a
a
a
a
a
a
a
"}
(80,1,1) = {"
a
a
a
a
a
a
a
a
a
a
a
a
a
a
a
a
a
a
a
a
a
a
a
a
a
a
a
l
l
a
a
a
a
a
a
a
a
a
a
a
a
a
a
a
a
a
a
a
a
l
a
a
a
a
a
a
a
a
a
a
a
a
Z
Z
Z
Z
a
Z
Z
Z
Z
Z
a
a
a
a
a
a
a
a
a
a
a
a
a
a
a
a
a
a
a
a
a
a
a
a
a
a
a
a
"}
(81,1,1) = {"
a
a
a
a
a
a
a
a
a
a
a
a
a
a
a
a
a
a
a
a
a
a
a
a
a
a
a
T
l
l
a
a
a
a
a
a
a
a
a
a
a
a
a
a
a
a
a
a
a
l
T
l
a
a
a
a
a
a
a
a
a
a
Z
Z
Z
Z
Z
Z
Z
Z
Z
Z
a
a
a
a
a
a
a
a
a
a
a
a
a
a
a
a
a
a
a
a
a
l
l
l
a
a
a
a
"}
(82,1,1) = {"
a
a
a
a
a
a
a
a
a
a
a
a
a
a
a
a
a
a
a
a
a
a
a
a
a
a
a
l
l
l
l
a
a
a
a
a
a
a
a
a
a
a
a
a
a
a
a
a
a
a
a
l
a
a
a
a
a
a
a
a
a
a
Z
Z
Z
Z
Z
Z
Z
Z
Z
Z
a
a
a
a
a
a
a
a
a
a
a
a
a
a
a
a
a
a
a
a
a
a
T
l
a
a
a
a
"}
(83,1,1) = {"
a
a
a
a
a
a
a
a
a
a
a
a
a
a
a
a
a
a
a
a
a
a
a
a
a
a
a
a
l
T
T
a
a
a
a
a
a
a
a
a
a
a
a
a
a
a
a
a
a
a
a
a
a
a
a
a
a
a
a
a
a
a
Z
Z
Z
Z
Z
Z
Z
Z
Z
Z
a
a
a
a
a
a
a
a
a
a
a
a
a
a
a
a
a
a
a
a
a
a
a
l
a
a
a
a
"}
(84,1,1) = {"
a
a
a
a
a
a
a
a
a
a
a
a
a
a
a
a
a
a
a
a
a
a
a
a
a
a
a
a
a
a
a
a
a
a
a
a
a
a
a
a
a
a
a
a
a
a
a
a
a
a
a
a
a
a
a
a
a
a
a
a
a
a
Z
Z
Z
Z
Z
Z
Z
Z
Z
Z
a
a
a
a
a
a
a
a
a
a
a
a
a
a
a
a
a
a
a
a
a
a
a
a
a
a
a
a
"}
(85,1,1) = {"
a
a
a
a
a
a
a
a
a
a
a
a
a
a
a
a
a
a
a
a
a
a
a
a
a
a
a
a
a
a
a
a
a
a
a
a
a
a
a
a
a
a
a
a
a
a
a
a
a
a
a
a
a
a
a
a
a
a
a
a
a
a
Z
Z
Z
Z
Z
Z
Z
Z
Z
Z
a
a
a
a
a
a
a
a
a
a
a
a
a
a
a
a
a
a
a
a
a
a
a
a
a
a
a
a
"}
(86,1,1) = {"
a
a
a
a
a
a
a
a
a
a
a
a
a
a
a
a
a
a
a
a
a
a
a
a
a
a
a
a
a
a
a
a
a
a
a
a
a
a
a
a
a
a
a
a
a
a
a
a
a
a
a
a
a
a
a
a
a
a
a
a
a
a
a
a
a
a
a
a
a
a
a
a
a
a
a
a
a
a
a
a
a
a
a
a
a
a
a
a
a
a
a
a
a
a
a
a
a
a
a
a
"}
(87,1,1) = {"
a
a
a
a
a
a
a
a
a
a
a
a
a
a
a
a
a
a
a
a
a
a
a
a
a
a
a
a
a
a
a
a
a
a
a
a
a
a
a
a
a
a
a
a
a
a
a
a
a
a
a
a
a
a
a
a
a
a
a
a
a
a
a
a
a
a
a
a
a
a
a
a
a
a
a
a
a
a
a
a
a
a
a
a
a
a
a
a
a
a
a
a
a
a
a
a
a
a
a
a
"}
(88,1,1) = {"
a
a
a
a
a
a
a
a
a
a
a
a
a
a
a
a
a
a
a
a
a
a
a
a
a
a
a
a
a
a
a
a
a
a
a
a
a
a
l
l
a
a
a
a
a
a
a
a
a
a
a
a
a
a
a
a
a
a
a
a
a
a
a
a
a
a
a
a
a
a
a
a
a
a
a
a
a
a
a
a
a
a
a
a
a
a
a
a
a
a
a
a
a
a
a
a
a
a
a
a
"}
(89,1,1) = {"
a
a
a
a
a
a
a
a
a
a
a
a
a
a
a
a
a
a
a
a
a
a
a
a
a
a
a
a
a
a
a
a
a
a
a
a
a
a
T
l
l
a
a
a
a
a
a
a
a
a
a
a
a
a
a
a
a
a
a
a
a
a
a
a
a
a
a
a
a
a
a
a
a
a
a
a
a
a
a
a
a
a
a
a
a
a
a
a
a
a
a
a
a
a
a
a
a
a
a
a
"}
(90,1,1) = {"
a
a
a
a
a
a
a
a
a
a
a
a
a
a
a
a
a
a
a
a
a
a
a
a
a
a
a
a
a
a
a
a
a
a
a
a
a
a
a
a
l
a
a
a
a
a
a
a
a
a
a
a
a
a
a
a
a
a
a
a
a
a
a
a
a
a
a
a
a
a
a
a
a
a
a
a
a
a
a
a
a
a
a
a
a
a
a
a
a
a
a
a
a
a
a
a
a
a
a
a
"}
(91,1,1) = {"
a
a
a
a
a
a
a
a
a
a
a
a
a
a
a
a
a
a
a
a
a
a
a
a
a
a
a
a
a
a
a
a
a
a
a
a
a
a
a
a
a
a
a
a
a
a
a
a
a
a
a
a
a
a
a
a
a
a
a
a
a
a
a
a
a
a
a
a
a
a
a
a
a
a
a
a
a
a
a
a
a
a
a
a
a
a
a
a
a
a
a
a
a
a
a
a
a
a
a
a
"}
(92,1,1) = {"
a
a
a
a
a
a
a
a
a
a
a
a
a
a
a
a
a
a
a
a
a
a
a
a
a
a
a
a
a
a
a
a
a
a
a
a
a
a
a
a
a
a
a
a
a
a
a
a
a
a
a
a
a
a
a
a
a
a
a
a
a
a
a
a
a
a
a
a
a
a
a
a
a
a
a
a
a
a
a
a
a
a
a
a
a
a
a
a
a
a
a
a
a
a
a
a
a
a
a
a
"}
(93,1,1) = {"
a
a
a
a
a
a
a
a
a
a
a
a
a
a
a
a
a
a
a
a
a
a
a
a
a
a
a
a
a
a
a
a
a
a
a
a
a
a
a
a
a
a
a
a
a
a
a
a
a
a
a
a
a
a
a
a
a
a
a
a
a
a
a
a
a
a
a
a
a
a
a
a
a
a
a
a
a
a
a
a
a
a
a
a
a
a
a
a
a
a
a
a
a
a
a
a
a
a
a
a
"}
(94,1,1) = {"
W
W
W
W
W
W
W
W
W
W
W
W
W
y
W
W
W
W
W
W
W
W
W
W
W
W
W
W
W
W
W
W
W
W
W
W
W
W
W
W
W
W
W
W
W
W
W
W
W
W
W
W
W
W
W
W
W
W
W
W
W
W
W
W
W
W
W
W
W
W
W
W
W
W
W
W
W
W
W
W
W
W
W
W
W
W
W
W
W
W
W
W
W
W
W
W
W
W
W
W
"}
(95,1,1) = {"
W
W
W
W
W
W
W
W
W
W
W
W
W
W
W
W
W
W
W
W
W
W
W
W
W
W
W
W
W
W
W
W
W
W
W
W
W
W
W
W
W
W
W
W
W
W
W
W
W
W
W
W
W
W
W
W
W
W
W
W
W
W
W
W
W
W
W
W
W
W
W
W
W
W
W
W
W
W
W
W
W
W
W
W
W
W
W
W
W
W
W
W
W
W
W
W
W
W
W
W
"}
(96,1,1) = {"
W
W
W
W
W
W
W
W
W
W
W
W
W
W
W
W
W
W
W
W
W
W
W
W
W
W
W
W
W
W
W
W
W
W
W
W
W
W
W
W
W
W
W
W
W
W
W
W
W
W
W
W
W
W
W
W
W
W
W
W
W
W
W
W
W
W
W
W
W
W
W
W
W
W
W
W
W
W
W
W
W
W
W
W
W
W
W
W
W
W
W
W
W
W
W
W
W
W
W
W
"}
(97,1,1) = {"
W
W
W
W
W
W
W
W
W
W
W
W
W
W
W
W
W
W
W
W
W
W
W
W
W
W
W
W
W
W
W
W
W
W
W
W
W
W
W
W
W
W
W
W
W
W
W
W
W
W
W
W
W
W
W
W
W
W
W
W
W
W
W
W
W
W
W
W
W
W
W
W
W
W
W
W
W
W
W
W
W
W
W
W
W
W
W
W
W
W
W
W
W
W
W
W
W
W
W
W
"}
(98,1,1) = {"
W
W
W
W
W
W
W
W
W
W
W
W
W
W
W
W
W
W
W
W
W
W
W
W
W
W
W
W
W
W
W
W
W
W
W
W
W
W
W
W
W
W
W
W
W
W
W
W
W
W
W
W
W
W
W
W
W
W
W
W
W
W
W
W
W
W
W
W
W
W
W
W
W
W
W
W
W
W
W
W
W
W
W
W
W
W
W
W
W
W
W
W
W
W
W
W
W
W
W
W
"}
(99,1,1) = {"
W
W
W
W
W
W
W
W
W
W
W
W
W
W
W
W
W
W
W
W
W
W
W
W
W
W
W
W
W
W
W
W
W
W
W
W
W
W
W
W
W
W
W
W
W
W
W
W
W
W
W
W
W
W
W
W
W
W
W
W
W
W
W
W
W
W
W
W
W
W
W
W
W
W
W
W
W
W
W
W
W
W
W
W
W
W
W
W
W
W
W
W
W
W
W
W
W
W
K
W
"}
(100,1,1) = {"
W
W
W
W
W
W
W
W
W
W
W
W
W
W
W
W
W
W
W
W
W
W
W
W
W
W
W
W
W
W
W
W
W
W
W
W
W
W
W
W
W
W
W
W
W
W
W
W
W
W
W
W
W
W
W
W
W
W
W
W
W
W
W
W
W
W
W
W
W
W
W
W
W
W
W
W
W
W
W
W
W
W
W
W
W
W
W
W
W
W
W
W
W
W
W
W
W
W
W
i
"}
