//MAP CONVERTED BY dmm2tgm.py THIS HEADER COMMENT PREVENTS RECONVERSION, DO NOT REMOVE
"ah" = (
/obj/structure/particle_accelerator/particle_emitter/right,
/obj/effect/floor_decal/industrial/warning{
	dir = 5
	},
/turf/simulated/floor/tiled/steel_grid,
/area/ministation/enginecontrol)
"cH" = (
/obj/effect/floor_decal/industrial/warning{
	dir = 4
	},
/turf/simulated/floor/tiled/steel_grid,
/area/ministation/enginecontrol)
"df" = (
/obj/machinery/light{
	dir = 4;
	icon_state = "tube1"
	},
/turf/simulated/floor/tiled/steel_grid,
/area/ministation/enginecontrol)
"dm" = (
/obj/machinery/atmospherics/pipe/simple/hidden/supply{
	dir = 4
	},
/obj/machinery/atmospherics/binary/pump/on{
	target_pressure = 200;
	dir = 4
	},
/turf/simulated/floor/tiled/steel_grid,
/area/ministation/enginecontrol)
"dy" = (
/obj/machinery/atmospherics/pipe/simple/hidden/scrubbers{
	dir = 4
	},
/obj/machinery/power/terminal{
	dir = 1
	},
/obj/structure/cable/yellow{
	icon_state = "0-4"
	},
/obj/machinery/button/access/interior{
	id_tag = "sing_engineering_airlock1";
	name = "exterior access button";
	pixel_y = -25;
	dir = 1
	},
/obj/machinery/atmospherics/pipe/simple/hidden{
	dir = 4
	},
/turf/simulated/floor/tiled/steel_grid,
/area/ministation/enginecontrol)
"dR" = (
/obj/effect/wallframe_spawn/reinforced,
/obj/machinery/door/firedoor,
/turf/simulated/floor/plating,
/area/ministation/enginecontrol)
"dW" = (
/obj/effect/catwalk_plated,
/obj/structure/cable/yellow{
	icon_state = "4-8"
	},
/turf/simulated/floor/plating,
/area/ministation/engineroom)
"ga" = (
/obj/structure/particle_accelerator/particle_emitter/center,
/obj/effect/floor_decal/industrial/warning{
	dir = 1;
	icon_state = "warning"
	},
/turf/simulated/floor/tiled/steel_grid,
/area/ministation/enginecontrol)
"gJ" = (
/turf/simulated/wall/r_wall,
/area/ministation/enginecontrol)
"ha" = (
/turf/simulated/floor/tiled/steel_grid,
/area/ministation/enginecontrol)
"hK" = (
/obj/structure/cable{
	icon_state = "4-8"
	},
/obj/machinery/door/airlock/glass/engineering,
/obj/machinery/atmospherics/pipe/simple/hidden/scrubbers{
	dir = 4
	},
/obj/machinery/door/firedoor{
	dir = 8
	},
/obj/machinery/atmospherics/pipe/simple/visible{
	dir = 4
	},
/turf/simulated/floor/tiled/steel_grid,
/area/ministation/enginecontrol)
"iN" = (
/obj/structure/particle_accelerator/particle_emitter/left,
/obj/effect/floor_decal/industrial/warning{
	dir = 9
	},
/turf/simulated/floor/tiled/steel_grid,
/area/ministation/enginecontrol)
"jd" = (
/obj/machinery/rad_collector,
/turf/simulated/floor/plating,
/area/ministation/engineroom)
"jm" = (
/turf/simulated/wall/r_wall,
/area/ministation/engineroom)
"jF" = (
/obj/abstract/landmark/map_load_mark/engine_loader,
/turf/simulated/floor/plating,
/area/ministation/engineroom)
"jU" = (
/obj/structure/cable{
	icon_state = "1-2"
	},
/obj/machinery/door/airlock/external/glass{
	autoset_access = 0;
	id_tag = "sing_engineering_airlock_interior1";
	locked = 1
	},
/obj/machinery/atmospherics/pipe/simple/hidden{
	dir = 2
	},
/obj/structure/cable/yellow{
	icon_state = "1-2"
	},
/turf/simulated/floor/plating,
/area/ministation/enginecontrol)
"kE" = (
/obj/effect/catwalk_plated,
/obj/structure/cable/yellow{
	icon_state = "2-8"
	},
/turf/simulated/floor/plating,
/area/ministation/engineroom)
"lj" = (
/obj/machinery/rad_collector,
/obj/structure/cable/yellow{
	dir = 1
	},
/obj/structure/cable/yellow{
	icon_state = "1-2"
	},
/turf/simulated/floor/plating,
/area/ministation/engineroom)
"lN" = (
/obj/machinery/atmospherics/unary/vent_pump/on{
	dir = 1
	},
/obj/machinery/particle_accelerator/control_box,
/turf/simulated/floor/tiled/steel_grid,
/area/ministation/enginecontrol)
"mA" = (
/obj/structure/cable/yellow{
	icon_state = "1-2"
	},
/obj/effect/catwalk_plated,
/obj/structure/cable/yellow{
	icon_state = "1-4"
	},
/turf/simulated/floor/plating,
/area/ministation/engineroom)
"mD" = (
/obj/structure/cable{
	icon_state = "1-4"
	},
/turf/simulated/floor/tiled/steel_grid,
/area/ministation/enginecontrol)
"mP" = (
/obj/machinery/field_generator,
/turf/simulated/floor/plating,
/area/ministation/engineroom)
"ng" = (
/obj/machinery/atmospherics/pipe/simple/hidden/supply{
	dir = 4
	},
/turf/simulated/floor/tiled/steel_grid,
/area/ministation/enginecontrol)
"on" = (
/obj/machinery/door/airlock/external/glass{
	autoset_access = 0;
	id_tag = "sing_engineering_airlock_exterior";
	locked = 1
	},
/turf/simulated/floor/plating,
/area/ministation/enginecontrol)
"ox" = (
/obj/machinery/atmospherics/pipe/simple/hidden/supply{
	dir = 4
	},
/obj/machinery/button/access/interior{
	id_tag = "sing_engineering_airlock";
	name = "exterior access button";
	pixel_y = -25;
	dir = 1
	},
/turf/simulated/floor/tiled/steel_grid,
/area/ministation/enginecontrol)
"ps" = (
/obj/structure/cable/yellow{
	icon_state = "4-8"
	},
/turf/simulated/floor/plating,
/area/ministation/engineroom)
"py" = (
/obj/machinery/rad_collector,
/obj/structure/cable/yellow{
	icon_state = "0-8"
	},
/obj/structure/cable/yellow{
	icon_state = "0-8"
	},
/turf/simulated/floor/plating,
/area/ministation/engineroom)
"pN" = (
/obj/machinery/light{
	dir = 8;
	icon_state = "tube1"
	},
/obj/structure/closet/radiation,
/turf/simulated/floor/tiled/steel_grid,
/area/ministation/enginecontrol)
"qd" = (
/obj/structure/particle_accelerator/fuel_chamber,
/turf/simulated/floor/tiled/steel_grid,
/area/ministation/enginecontrol)
"qz" = (
/turf/space,
/area/ministation/engineroom)
"rb" = (
/obj/structure/cable{
	icon_state = "4-8"
	},
/obj/machinery/atmospherics/pipe/simple/hidden/scrubbers{
	dir = 4
	},
/obj/structure/cable{
	icon_state = "0-8"
	},
/obj/machinery/power/apc{
	areastring = null;
	name = "_South APC";
	pixel_y = -24
	},
/turf/simulated/floor/tiled/steel_grid,
/area/ministation/enginecontrol)
"rq" = (
/obj/structure/particle_accelerator/power_box,
/turf/simulated/floor/tiled/steel_grid,
/area/ministation/enginecontrol)
"tR" = (
/obj/effect/wallframe_spawn/reinforced_borosilicate,
/obj/machinery/door/blast/regular{
	id_tag = "EngineBlastinterior"
	},
/turf/simulated/floor/plating,
/area/ministation/enginecontrol)
"vi" = (
/obj/structure/cable{
	icon_state = "1-2"
	},
/obj/structure/cable{
	icon_state = "1-4"
	},
/obj/machinery/atmospherics/pipe/simple/hidden/scrubbers{
	dir = 4
	},
/obj/structure/cable/yellow{
	icon_state = "2-8"
	},
/obj/machinery/atmospherics/pipe/manifold/hidden{
	dir = 4
	},
/turf/simulated/floor/tiled/steel_grid,
/area/ministation/enginecontrol)
"vx" = (
/obj/machinery/atmospherics/pipe/simple/hidden/scrubbers{
	dir = 6
	},
/obj/machinery/atmospherics/pipe/simple/hidden{
	dir = 4
	},
/turf/simulated/floor/tiled/steel_grid,
/area/ministation/enginecontrol)
"vA" = (
/obj/structure/tank_rack/hydrogen,
/turf/simulated/floor/tiled/steel_grid,
/area/ministation/enginecontrol)
"wy" = (
/obj/machinery/rad_collector,
/obj/structure/cable/yellow{
	dir = 1
	},
/obj/structure/cable/yellow{
	dir = 1
	},
/turf/simulated/floor/plating,
/area/ministation/engineroom)
"xy" = (
/obj/structure/particle_accelerator/end_cap,
/turf/simulated/floor/tiled/steel_grid,
/area/ministation/enginecontrol)
"yb" = (
/obj/machinery/firealarm{
	dir = 4;
	pixel_x = 24
	},
/turf/simulated/floor/tiled/steel_grid,
/area/ministation/enginecontrol)
"yl" = (
/obj/machinery/atmospherics/pipe/simple/hidden/supply,
/turf/simulated/floor/tiled/steel_grid,
/area/ministation/enginecontrol)
"yG" = (
/obj/effect/catwalk_plated,
/obj/structure/cable/yellow{
	icon_state = "1-2"
	},
/turf/simulated/floor/plating,
/area/ministation/engineroom)
"zE" = (
/obj/machinery/door/airlock/glass/engineering,
/obj/machinery/atmospherics/pipe/simple/hidden/supply{
	dir = 4
	},
/obj/machinery/door/firedoor{
	dir = 8
	},
/turf/simulated/floor/tiled/steel_grid,
/area/ministation/enginecontrol)
"zR" = (
/obj/machinery/atmospherics/pipe/simple/hidden{
	dir = 4
	},
/turf/simulated/floor/tiled/steel_grid,
/area/ministation/enginecontrol)
"AZ" = (
/obj/machinery/atmospherics/pipe/simple/hidden/supply{
	dir = 10
	},
/obj/machinery/atmospherics/binary/pump/on{
	target_pressure = 200;
	dir = 4
	},
/turf/simulated/floor/tiled/steel_grid,
/area/ministation/enginecontrol)
"Bp" = (
/obj/machinery/button/access/interior{
	id_tag = "sing_engineering_airlock";
	name = "interior access button";
	pixel_x = 20;
	pixel_y = 20;
	command = "cycle_exterior"
	},
/obj/effect/catwalk_plated,
/turf/space,
/area/ministation/engineroom)
"BD" = (
/obj/machinery/door/airlock/external/glass{
	autoset_access = 0;
	id_tag = "sing_engineering_airlock_exterior1";
	locked = 1
	},
/obj/structure/cable/yellow{
	icon_state = "1-2"
	},
/turf/simulated/floor/plating,
/area/ministation/enginecontrol)
"BV" = (
/obj/machinery/atmospherics/pipe/simple/hidden/scrubbers,
/turf/simulated/floor/tiled/steel_grid,
/area/ministation/enginecontrol)
"CO" = (
/obj/effect/catwalk_plated,
/obj/structure/cable/yellow{
	icon_state = "1-4"
	},
/turf/simulated/floor/plating,
/area/ministation/engineroom)
"Fi" = (
/obj/structure/cable{
	icon_state = "2-8"
	},
/obj/machinery/atmospherics/portables_connector,
/obj/machinery/portable_atmospherics/canister/air/airlock{
	pixel_x = 1
	},
/turf/simulated/floor/tiled/steel_grid,
/area/ministation/enginecontrol)
"FF" = (
/obj/machinery/atmospherics/unary/vent_pump/high_volume/external_air{
	dir = 1;
	id_tag = "sing_engineering_vent1"
	},
/obj/structure/cable/yellow{
	icon_state = "1-2"
	},
/obj/machinery/embedded_controller/radio/airlock/airlock_controller{
	id_tag = "sing_engineering_airlock1";
	tag_airpump = "sing_engineering_vent1";
	tag_chamber_sensor = "sing_engineering_sensor1";
	tag_exterior_door = "sing_engineering_airlock_exterior1";
	tag_interior_door = "sing_engineering_airlock_interior1";
	dir = 4;
	pixel_x = -24
	},
/obj/machinery/airlock_sensor{
	id_tag = "sing_engineering_sensor1";
	dir = 8;
	pixel_x = 20
	},
/turf/simulated/floor/plating,
/area/ministation/enginecontrol)
"FG" = (
/obj/structure/cable{
	icon_state = "4-8"
	},
/turf/simulated/floor/tiled/steel_grid,
/area/ministation/enginecontrol)
"FX" = (
/obj/structure/cable{
	icon_state = "1-2"
	},
/obj/effect/wallframe_spawn/reinforced,
/obj/machinery/door/firedoor,
/turf/simulated/floor/plating,
/area/ministation/enginecontrol)
"Gi" = (
/obj/machinery/atmospherics/portables_connector,
/obj/machinery/portable_atmospherics/canister/air/airlock{
	pixel_x = 1
	},
/turf/simulated/floor/tiled/steel_grid,
/area/ministation/enginecontrol)
"GG" = (
/obj/machinery/atmospherics/unary/vent_pump/high_volume/external_air{
	dir = 1;
	id_tag = "sing_engineering_vent"
	},
/obj/machinery/embedded_controller/radio/airlock/airlock_controller{
	id_tag = "sing_engineering_airlock";
	tag_airpump = "sing_engineering_vent";
	tag_chamber_sensor = "sing_engineering_sensor";
	tag_exterior_door = "sing_engineering_airlock_exterior";
	tag_interior_door = "sing_engineering_airlock_interior";
	dir = 8;
	pixel_x = 24
	},
/obj/machinery/airlock_sensor{
	id_tag = "sing_engineering_sensor";
	dir = 4;
	pixel_x = -20
	},
/turf/simulated/floor/plating,
/area/ministation/enginecontrol)
"Hr" = (
/obj/machinery/atmospherics/pipe/simple/hidden/scrubbers{
	dir = 4
	},
/obj/machinery/atmospherics/pipe/simple/hidden{
	dir = 4
	},
/turf/simulated/floor/tiled/steel_grid,
/area/ministation/enginecontrol)
"Hx" = (
/obj/machinery/button/blast_door{
	desc = "A remote control-switch for the engine control room blast doors.";
	id_tag = "EngineBlastinterior";
	name = "Engine Monitoring Room Blast Doors";
	pixel_x = -20
	},
/turf/simulated/floor/tiled/steel_grid,
/area/ministation/enginecontrol)
"If" = (
/obj/structure/closet/radiation,
/turf/simulated/floor/tiled/steel_grid,
/area/ministation/enginecontrol)
"Ii" = (
/obj/machinery/emitter{
	dir = 4
	},
/obj/structure/cable/yellow{
	icon_state = "1-4"
	},
/obj/structure/cable/yellow{
	icon_state = "2-4"
	},
/obj/structure/cable/yellow{
	icon_state = "0-4"
	},
/turf/simulated/floor/plating,
/area/ministation/engineroom)
"Iw" = (
/obj/machinery/atmospherics/pipe/simple/hidden/universal{
	dir = 4
	},
/turf/simulated/floor/tiled/steel_grid,
/area/ministation/enginecontrol)
"IC" = (
/obj/effect/catwalk_plated,
/obj/structure/cable/yellow{
	icon_state = "2-8"
	},
/obj/structure/cable/yellow{
	icon_state = "1-2"
	},
/turf/simulated/floor/plating,
/area/ministation/engineroom)
"JE" = (
/obj/machinery/atmospherics/pipe/simple/hidden/supply{
	dir = 4
	},
/obj/machinery/atmospherics/pipe/manifold/hidden{
	dir = 4
	},
/turf/simulated/floor/tiled/steel_grid,
/area/ministation/enginecontrol)
"JY" = (
/obj/machinery/rad_collector,
/obj/structure/cable/yellow{
	icon_state = "0-4"
	},
/obj/structure/cable/yellow{
	icon_state = "0-4"
	},
/turf/simulated/floor/plating,
/area/ministation/engineroom)
"KA" = (
/obj/machinery/button/access/interior{
	id_tag = "sing_engineering_airlock1";
	name = "interior access button";
	pixel_x = -20;
	pixel_y = 20;
	command = "cycle_exterior"
	},
/obj/effect/catwalk_plated,
/obj/structure/cable/yellow{
	icon_state = "1-2"
	},
/turf/simulated/floor/plating,
/area/ministation/engineroom)
"Lt" = (
/obj/effect/catwalk_plated,
/turf/space,
/area/ministation/engineroom)
"Lv" = (
/obj/machinery/alarm{
	dir = 4;
	pixel_x = -24
	},
/turf/simulated/floor/tiled/steel_grid,
/area/ministation/enginecontrol)
"Lx" = (
/obj/effect/floor_decal/industrial/warning{
	dir = 8
	},
/turf/simulated/floor/tiled/steel_grid,
/area/ministation/enginecontrol)
"LY" = (
/obj/machinery/singularity_generator,
/turf/simulated/floor/plating,
/area/ministation/engineroom)
"MD" = (
/obj/machinery/rad_collector,
/obj/structure/cable/yellow,
/turf/simulated/floor/plating,
/area/ministation/engineroom)
"Nc" = (
/obj/structure/cable/yellow{
	icon_state = "1-2"
	},
/obj/effect/wallframe_spawn/reinforced_borosilicate,
/obj/machinery/door/blast/regular{
	id_tag = "EngineBlastinterior"
	},
/turf/simulated/floor/plating,
/area/ministation/enginecontrol)
"Nh" = (
/turf/simulated/floor/plating,
/area/ministation/engineroom)
"Nq" = (
/turf/space,
/area/space)
"NK" = (
/obj/machinery/door/airlock/external/glass{
	autoset_access = 0;
	id_tag = "sing_engineering_airlock_interior";
	locked = 1
	},
/obj/machinery/atmospherics/pipe/simple/hidden{
	dir = 2
	},
/turf/simulated/floor/plating,
/area/ministation/enginecontrol)
"NW" = (
/obj/machinery/emitter{
	dir = 8
	},
/obj/structure/cable/yellow{
	icon_state = "2-8"
	},
/obj/structure/cable/yellow{
	icon_state = "1-8"
	},
/obj/structure/cable/yellow{
	icon_state = "0-8"
	},
/turf/simulated/floor/plating,
/area/ministation/engineroom)
"Pb" = (
/obj/machinery/emitter{
	dir = 4
	},
/obj/structure/cable/yellow{
	icon_state = "2-4"
	},
/obj/structure/cable/yellow{
	icon_state = "1-4"
	},
/obj/structure/cable/yellow{
	icon_state = "0-4"
	},
/turf/simulated/floor/plating,
/area/ministation/engineroom)
"Pi" = (
/obj/structure/lattice,
/turf/space,
/area/ministation/engineroom)
"PW" = (
/obj/machinery/atmospherics/unary/vent_scrubber/on{
	dir = 1
	},
/turf/simulated/floor/tiled/steel_grid,
/area/ministation/enginecontrol)
"Qt" = (
/obj/structure/cable{
	icon_state = "4-8"
	},
/obj/structure/reagent_dispensers/fueltank,
/turf/simulated/floor/tiled/steel_grid,
/area/ministation/enginecontrol)
"Rq" = (
/obj/effect/catwalk_plated,
/obj/structure/cable/yellow{
	icon_state = "1-2"
	},
/obj/structure/cable/yellow{
	icon_state = "1-4"
	},
/turf/simulated/floor/plating,
/area/ministation/engineroom)
"Rr" = (
/obj/structure/cable{
	icon_state = "4-8"
	},
/obj/machinery/atmospherics/pipe/simple/hidden/scrubbers{
	dir = 4
	},
/turf/simulated/floor/tiled/steel_grid,
/area/ministation/enginecontrol)
"Ry" = (
/obj/effect/catwalk_plated,
/obj/structure/cable/yellow{
	icon_state = "1-2"
	},
/obj/structure/cable/yellow{
	icon_state = "2-8"
	},
/turf/simulated/floor/plating,
/area/ministation/engineroom)
"SA" = (
/obj/machinery/rad_collector,
/obj/structure/cable/yellow,
/obj/structure/cable/yellow{
	icon_state = "1-2"
	},
/turf/simulated/floor/plating,
/area/ministation/engineroom)
"SH" = (
/obj/machinery/emitter{
	dir = 8
	},
/obj/structure/cable/yellow{
	icon_state = "1-8"
	},
/obj/structure/cable/yellow{
	icon_state = "2-8"
	},
/obj/structure/cable/yellow{
	icon_state = "0-8"
	},
/turf/simulated/floor/plating,
/area/ministation/engineroom)
"SM" = (
/obj/structure/cable{
	icon_state = "4-8"
	},
/obj/machinery/light{
	dir = 1;
	icon_state = "tube1"
	},
/obj/machinery/power/smes/buildable/max_cap_in_out{
	capacity = 5e+009;
	charge = 5e+009
	},
/obj/structure/cable{
	icon_state = "0-8"
	},
/turf/simulated/floor/tiled/steel_grid,
/area/ministation/enginecontrol)
"Uf" = (
/obj/effect/catwalk_plated,
/obj/structure/cable/yellow{
	icon_state = "1-8"
	},
/turf/simulated/floor/plating,
/area/ministation/engineroom)
"Uw" = (
/obj/effect/floor_decal/industrial/hatch/red,
/obj/structure/extinguisher_cabinet{
	pixel_x = -5;
	pixel_y = 30
	},
/turf/simulated/floor/tiled/steel_grid,
/area/ministation/enginecontrol)
"Wa" = (
/obj/machinery/light{
	dir = 1;
	icon_state = "tube1"
	},
/obj/structure/tank_rack/hydrogen,
/turf/simulated/floor/tiled/steel_grid,
/area/ministation/enginecontrol)
"XC" = (
/obj/machinery/light{
	dir = 4;
	icon_state = "tube1"
	},
/obj/structure/closet/radiation,
/turf/simulated/floor/tiled/steel_grid,
/area/ministation/enginecontrol)
"Zx" = (
/obj/machinery/light{
	dir = 8;
	icon_state = "tube1"
	},
/turf/simulated/floor/tiled/steel_grid,
/area/ministation/enginecontrol)
"ZR" = (
/obj/machinery/rad_collector,
/obj/structure/cable/yellow{
	dir = 1
	},
/turf/simulated/floor/plating,
/area/ministation/engineroom)

(1,1,1) = {"
gJ
gJ
zE
gJ
jm
jm
jm
jm
jm
jm
jm
jm
jm
jm
jm
jm
jm
Nq
Nq
Nq
Nq
Nq
Nq
Nq
Nq
Nq
Nq
Nq
Nq
Nq
Nq
Nq
"}
(2,1,1) = {"
gJ
pN
ng
gJ
qz
qz
qz
qz
qz
qz
Pi
qz
qz
qz
qz
qz
Pi
Nq
Nq
Nq
Nq
Nq
Nq
Nq
Nq
Nq
Nq
Nq
Nq
Nq
Nq
Nq
"}
(3,1,1) = {"
gJ
If
Iw
gJ
qz
qz
qz
qz
qz
qz
wy
Ii
SA
MD
qz
ZR
lj
Pb
MD
Nq
Nq
Nq
Nq
Nq
Nq
Nq
Nq
Nq
Nq
Nq
Nq
Nq
"}
(4,1,1) = {"
gJ
ha
dm
gJ
gJ
gJ
qz
qz
qz
JY
Pi
ps
qz
qz
qz
Pi
qz
ps
qz
Nq
Nq
Nq
Nq
Nq
Nq
Nq
Nq
Nq
Nq
Nq
Nq
Nq
"}
(5,1,1) = {"
gJ
Gi
JE
NK
GG
on
Bp
Lt
Lt
kE
yG
IC
yG
yG
yG
yG
yG
Ry
CO
Nq
Nq
Nq
Nq
Nq
Nq
Nq
Nq
Nq
Nq
Nq
Nq
Nq
"}
(6,1,1) = {"
gJ
Wa
ox
gJ
gJ
gJ
gJ
gJ
gJ
qz
qz
mP
Pi
Pi
Pi
Pi
Pi
mP
dW
Nq
Nq
Nq
Nq
Nq
Nq
Nq
Nq
Nq
Nq
Nq
Nq
Nq
"}
(7,1,1) = {"
gJ
vA
Iw
ha
Zx
Hx
Lv
ha
tR
qz
qz
Pi
qz
qz
Pi
qz
qz
Pi
dW
Nq
Nq
Nq
Nq
Nq
Nq
Nq
Nq
Nq
Nq
Nq
Nq
Nq
"}
(8,1,1) = {"
dR
ha
AZ
yl
lN
ha
iN
Lx
tR
qz
qz
Pi
qz
Nh
Nh
Nh
qz
Pi
dW
Nq
Nq
Nq
Nq
Nq
Nq
Nq
Nq
Nq
Nq
Nq
Nq
Nq
"}
(9,1,1) = {"
FX
mD
zR
xy
qd
rq
ga
ha
Nc
qz
qz
Pi
Pi
Nh
LY
jF
Pi
Pi
dW
Nq
Nq
Nq
Nq
Nq
Nq
Nq
Nq
Nq
Nq
Nq
Nq
Nq
"}
(10,1,1) = {"
dR
FG
vx
BV
PW
ha
ah
cH
tR
qz
qz
Pi
qz
Nh
Nh
Nh
qz
Pi
dW
Nq
Nq
Nq
Nq
Nq
Nq
Nq
Nq
Nq
Nq
Nq
Nq
Nq
"}
(11,1,1) = {"
gJ
Qt
Hr
ha
df
yb
ha
ha
tR
qz
qz
Pi
qz
qz
Pi
qz
qz
Pi
dW
Nq
Nq
Nq
Nq
Nq
Nq
Nq
Nq
Nq
Nq
Nq
Nq
Nq
"}
(12,1,1) = {"
gJ
SM
dy
gJ
gJ
gJ
gJ
gJ
gJ
qz
qz
mP
Pi
Pi
Pi
Pi
Pi
mP
dW
Nq
Nq
Nq
Nq
Nq
Nq
Nq
Nq
Nq
Nq
Nq
Nq
Nq
"}
(13,1,1) = {"
gJ
Fi
vi
jU
FF
BD
KA
yG
yG
Rq
yG
Rq
yG
yG
yG
yG
yG
mA
Uf
Nq
Nq
Nq
Nq
Nq
Nq
Nq
Nq
Nq
Nq
Nq
Nq
Nq
"}
(14,1,1) = {"
gJ
Uw
Rr
gJ
gJ
gJ
qz
qz
qz
py
Pi
ps
qz
qz
qz
Pi
qz
ps
qz
Nq
Nq
Nq
Nq
Nq
Nq
Nq
Nq
Nq
Nq
Nq
Nq
Nq
"}
(15,1,1) = {"
gJ
If
rb
gJ
qz
qz
qz
qz
qz
qz
ZR
SH
SA
jd
qz
ZR
lj
NW
MD
Nq
Nq
Nq
Nq
Nq
Nq
Nq
Nq
Nq
Nq
Nq
Nq
Nq
"}
(16,1,1) = {"
gJ
XC
Rr
gJ
qz
qz
qz
qz
qz
qz
Pi
qz
qz
qz
qz
qz
Pi
Nq
Nq
Nq
Nq
Nq
Nq
Nq
Nq
Nq
Nq
Nq
Nq
Nq
Nq
Nq
"}
(17,1,1) = {"
gJ
gJ
hK
gJ
jm
jm
jm
jm
jm
jm
jm
jm
jm
jm
jm
jm
jm
Nq
Nq
Nq
Nq
Nq
Nq
Nq
Nq
Nq
Nq
Nq
Nq
Nq
Nq
Nq
"}
