//MAP CONVERTED BY dmm2tgm.py THIS HEADER COMMENT PREVENTS RECONVERSION, DO NOT REMOVE
"aa" = (
/turf/space,
/area/space)
"ab" = (
/turf/simulated/floor/reinforced/airless,
/area/shelltooth/level_four)
"ac" = (
/turf/simulated/floor/reinforced/airless,
/area/shelltooth/level_four/xenobotany)
"ad" = (
/turf/simulated/wall,
/area/shelltooth/level_four/hall)
"ae" = (
/turf/simulated/floor/reinforced/airless,
/area/space)
"af" = (
/turf/simulated/floor/reinforced/airless,
/area/shelltooth/level_four/hall)
"ag" = (
/turf/simulated/floor/tiled,
/area/shelltooth/level_four/hall)
"ah" = (
/obj/machinery/light{
	icon_state = "tube_map";
	dir = 1
	},
/turf/simulated/floor/tiled,
/area/shelltooth/level_four/hall)
"ai" = (
/obj/effect/floor_decal/industrial/warning/corner,
/obj/structure/catwalk,
/turf/simulated/floor,
/area/shelltooth/level_four/hall)
"aj" = (
/obj/structure/railing/mapped,
/obj/effect/floor_decal/industrial/warning,
/obj/structure/catwalk,
/turf/simulated/floor,
/area/shelltooth/level_four/hall)
"ak" = (
/obj/structure/railing/mapped,
/obj/effect/floor_decal/industrial/warning,
/obj/structure/catwalk,
/obj/machinery/light{
	icon_state = "tube_map";
	dir = 1
	},
/turf/simulated/floor,
/area/shelltooth/level_four/hall)
"al" = (
/obj/effect/floor_decal/industrial/warning/corner{
	icon_state = "stripecorner";
	dir = 8
	},
/obj/structure/catwalk,
/turf/simulated/floor,
/area/shelltooth/level_four/hall)
"am" = (
/obj/structure/railing/mapped{
	icon_state = "railing0-1";
	dir = 4
	},
/obj/effect/floor_decal/industrial/warning{
	icon_state = "stripe";
	dir = 4
	},
/obj/structure/catwalk,
/turf/simulated/floor,
/area/shelltooth/level_four/hall)
"an" = (
/turf/simulated/open,
/area/shelltooth/level_four/hall)
"ao" = (
/obj/structure/railing/mapped{
	icon_state = "railing0-1";
	dir = 8
	},
/obj/effect/floor_decal/industrial/warning{
	icon_state = "stripe";
	dir = 8
	},
/obj/structure/catwalk,
/turf/simulated/floor,
/area/shelltooth/level_four/hall)
"ap" = (
/obj/effect/floor_decal/industrial/warning{
	icon_state = "stripe";
	dir = 8
	},
/obj/structure/catwalk,
/turf/simulated/floor,
/area/shelltooth/level_four/hall)
"aq" = (
/obj/machinery/light{
	icon_state = "tube_map";
	dir = 8
	},
/turf/simulated/floor/tiled,
/area/shelltooth/level_four/hall)
"ar" = (
/obj/machinery/light{
	icon_state = "tube_map";
	dir = 4
	},
/turf/simulated/floor/tiled,
/area/shelltooth/level_four/hall)
"as" = (
/obj/effect/floor_decal/industrial/warning{
	icon_state = "stripe";
	dir = 4
	},
/obj/structure/catwalk,
/turf/simulated/floor,
/area/shelltooth/level_four/hall)
"at" = (
/obj/structure/railing/mapped{
	icon_state = "railing0-1";
	dir = 1
	},
/obj/structure/ladder,
/turf/simulated/open,
/area/shelltooth/level_four/hall)
"au" = (
/obj/structure/lattice,
/obj/structure/railing/mapped{
	icon_state = "railing0-1";
	dir = 1
	},
/obj/structure/cable{
	icon_state = "32-4"
	},
/obj/machinery/atmospherics/pipe/zpipe/down/supply{
	icon_state = "down-supply";
	dir = 4
	},
/obj/machinery/atmospherics/pipe/zpipe/down/scrubbers{
	icon_state = "down-scrubbers";
	dir = 4
	},
/turf/simulated/open,
/area/shelltooth/level_four/hall)
"av" = (
/obj/structure/railing/mapped{
	icon_state = "railing0-1";
	dir = 1
	},
/obj/structure/lattice,
/obj/machinery/atmospherics/pipe/manifold/hidden/scrubbers{
	icon_state = "map-scrubbers";
	dir = 1
	},
/obj/machinery/atmospherics/pipe/manifold/hidden/supply{
	dir = 1
	},
/obj/structure/cable{
	d1 = 2;
	d2 = 8;
	icon_state = "2-8"
	},
/obj/structure/cable{
	icon_state = "4-8"
	},
/turf/simulated/open,
/area/shelltooth/level_four/hall)
"aw" = (
/obj/structure/railing/mapped{
	icon_state = "railing0-1";
	dir = 1
	},
/obj/structure/lattice,
/obj/machinery/atmospherics/pipe/zpipe/up/scrubbers{
	icon_state = "up-scrubbers";
	dir = 8
	},
/obj/machinery/atmospherics/pipe/zpipe/up/supply{
	icon_state = "up-supply";
	dir = 8
	},
/obj/structure/cable{
	icon_state = "16-0"
	},
/obj/structure/cable{
	icon_state = "0-8"
	},
/turf/simulated/open,
/area/shelltooth/level_four/hall)
"ax" = (
/obj/structure/railing/mapped{
	icon_state = "railing0-1";
	dir = 1
	},
/obj/structure/lattice,
/turf/simulated/open,
/area/shelltooth/level_four/hall)
"ay" = (
/obj/effect/floor_decal/industrial/warning{
	icon_state = "stripe";
	dir = 8
	},
/obj/structure/catwalk,
/obj/machinery/atmospherics/pipe/simple/hidden/supply{
	icon_state = "intact-supply";
	dir = 6;
	pixel_y = 0
	},
/obj/machinery/atmospherics/pipe/simple/hidden/scrubbers{
	icon_state = "intact-scrubbers";
	dir = 6
	},
/turf/simulated/floor,
/area/shelltooth/level_four/hall)
"az" = (
/obj/effect/floor_decal/industrial/warning/corner{
	icon_state = "stripecorner";
	dir = 4
	},
/obj/structure/catwalk,
/turf/simulated/floor,
/area/shelltooth/level_four/hall)
"aA" = (
/obj/effect/floor_decal/industrial/warning{
	icon_state = "stripe";
	dir = 1
	},
/obj/structure/catwalk,
/turf/simulated/floor,
/area/shelltooth/level_four/hall)
"aB" = (
/obj/machinery/atmospherics/pipe/simple/hidden/supply{
	icon_state = "intact-supply";
	dir = 8
	},
/obj/machinery/atmospherics/pipe/simple/hidden/scrubbers{
	dir = 4
	},
/turf/simulated/floor/tiled,
/area/shelltooth/level_four/hall)
"aC" = (
/obj/effect/floor_decal/industrial/warning{
	icon_state = "stripe";
	dir = 8
	},
/obj/structure/catwalk,
/obj/machinery/atmospherics/pipe/simple/hidden/supply,
/obj/machinery/atmospherics/pipe/simple/hidden/scrubbers,
/turf/simulated/floor,
/area/shelltooth/level_four/hall)
"aD" = (
/turf/simulated/floor/reinforced/airless,
/area/shelltooth/level_four/xenobiology)
"aE" = (
/turf/simulated/wall,
/area/shelltooth/level_four/xenobiology)
"aF" = (
/turf/simulated/floor/reinforced/airless,
/area/shelltooth/level_four/science)
"aG" = (
/turf/simulated/wall,
/area/shelltooth/level_four/science)
"aH" = (
/turf/simulated/wall,
/area/shelltooth/level_four/brig)
"aI" = (
/turf/simulated/floor/reinforced/airless,
/area/shelltooth/level_four/brig)
"aJ" = (
/turf/space,
/area/shelltooth/maint/level_four/north_east)
"aK" = (
/turf/simulated/floor/reinforced/airless,
/area/shelltooth/maint/level_four/north_east)
"aL" = (
/obj/structure/railing/mapped{
	icon_state = "railing0-1";
	dir = 8
	},
/obj/effect/floor_decal/industrial/warning{
	icon_state = "stripe";
	dir = 8
	},
/obj/structure/catwalk,
/obj/machinery/atmospherics/pipe/simple/hidden/supply,
/obj/machinery/atmospherics/pipe/simple/hidden/scrubbers,
/turf/simulated/floor,
/area/shelltooth/level_four/hall)
"aM" = (
/obj/machinery/light,
/turf/simulated/floor/tiled,
/area/shelltooth/level_four/hall)
"aN" = (
/turf/simulated/wall,
/area/shelltooth/level_four/bot_storage)
"aO" = (
/turf/simulated/floor/reinforced/airless,
/area/shelltooth/level_four/bot_storage)
"aP" = (
/turf/simulated/wall,
/area/shelltooth/level_four/storage)
"aQ" = (
/turf/simulated/floor/reinforced/airless,
/area/shelltooth/level_four/storage)
"aR" = (
/turf/simulated/floor/reinforced/airless,
/area/shelltooth/maint/level_four/east)
"aS" = (
/turf/simulated/wall,
/area/shelltooth/maint/level_four/north_east)
"aT" = (
/turf/simulated/wall,
/area/shelltooth/maint/level_four/east)
"aU" = (
/obj/effect/floor_decal/industrial/warning/corner{
	icon_state = "stripecorner";
	dir = 1
	},
/obj/effect/floor_decal/industrial/warning{
	icon_state = "stripe";
	dir = 8
	},
/obj/structure/catwalk,
/obj/machinery/atmospherics/pipe/simple/hidden/supply,
/obj/machinery/atmospherics/pipe/simple/hidden/scrubbers,
/turf/simulated/floor,
/area/shelltooth/level_four/hall)
"aV" = (
/obj/effect/floor_decal/industrial/warning{
	icon_state = "stripe";
	dir = 1
	},
/obj/machinery/atmospherics/pipe/cap/hidden/scrubbers{
	icon_state = "cap-scrubbers";
	dir = 1
	},
/obj/machinery/atmospherics/pipe/cap/hidden/supply{
	icon_state = "cap-supply";
	dir = 1
	},
/obj/structure/cable{
	icon_state = "1-4"
	},
/obj/structure/catwalk,
/obj/machinery/light,
/obj/machinery/atmospherics/pipe/simple/hidden/supply{
	icon_state = "intact-supply";
	dir = 5
	},
/obj/machinery/atmospherics/pipe/simple/hidden/scrubbers{
	dir = 5
	},
/turf/simulated/floor,
/area/shelltooth/level_four/hall)
"aW" = (
/obj/effect/floor_decal/industrial/warning{
	icon_state = "stripe";
	dir = 1
	},
/obj/structure/cable{
	icon_state = "4-8"
	},
/obj/structure/catwalk,
/obj/machinery/atmospherics/pipe/simple/hidden/supply{
	icon_state = "intact-supply";
	dir = 8
	},
/obj/machinery/atmospherics/pipe/simple/hidden/scrubbers{
	dir = 4
	},
/turf/simulated/floor,
/area/shelltooth/level_four/hall)
"aX" = (
/obj/effect/floor_decal/industrial/warning/corner{
	icon_state = "stripecorner";
	dir = 1
	},
/obj/structure/cable{
	icon_state = "0-8"
	},
/obj/machinery/power/apc/high{
	icon_state = "apc0";
	dir = 4
	},
/obj/structure/catwalk,
/obj/machinery/atmospherics/pipe/simple/hidden/supply{
	dir = 9;
	pixel_y = 0
	},
/obj/machinery/atmospherics/pipe/simple/hidden/scrubbers{
	dir = 9
	},
/turf/simulated/floor,
/area/shelltooth/level_four/hall)
"aY" = (
/obj/machinery/atmospherics/pipe/simple/hidden/scrubbers{
	dir = 9
	},
/obj/machinery/atmospherics/pipe/simple/hidden/supply{
	icon_state = "intact-supply";
	dir = 10
	},
/turf/simulated/floor/tiled,
/area/shelltooth/level_four/hall)
"aZ" = (
/obj/machinery/atmospherics/unary/vent_scrubber/on,
/turf/simulated/floor/tiled,
/area/shelltooth/level_four/hall)
"ba" = (
/obj/machinery/atmospherics/unary/vent_pump/on{
	icon_state = "map_vent_out";
	dir = 1;
	level = 2
	},
/turf/simulated/floor/tiled,
/area/shelltooth/level_four/hall)

(1,1,1) = {"
aa
aa
aa
aa
aa
aa
aa
aa
aa
aa
aa
aa
aa
aa
aa
aa
aa
aa
aa
aa
aa
aa
aa
aa
aa
aa
aa
aa
aa
aa
aa
aa
aa
aa
aa
aa
aa
aa
aa
aa
aa
aa
aa
aa
aa
aa
aa
aa
aa
aa
aa
aa
aa
aa
aa
aa
aa
aa
aa
aa
aa
aa
aa
aa
"}
(2,1,1) = {"
aa
aa
aa
aa
aa
aa
aa
aa
aa
aa
aa
aa
aa
aa
aa
aa
aa
aa
aa
aa
aa
aa
aa
aa
aa
aa
aa
aa
aa
aa
aa
aa
aa
aa
aa
aa
aa
aa
aa
aa
aa
aa
aa
aa
aa
aa
aa
aa
aa
aa
aa
aa
aa
aa
aa
aa
aa
aa
aa
aa
aa
aa
aa
aa
"}
(3,1,1) = {"
aa
aa
aa
aa
aa
aa
aa
aa
aa
aa
aa
aa
aa
aa
aa
aa
aa
aa
aa
aa
aa
aa
aa
aa
aa
aa
aa
aa
aa
aa
aa
aa
aa
aa
aa
aa
aa
aa
aa
aa
aa
aa
aa
aa
aa
aa
aa
aa
aa
aa
aa
aa
aa
aa
aa
aa
aa
aa
aa
aa
aa
aa
aa
aa
"}
(4,1,1) = {"
aa
aa
aa
aa
aa
aa
aa
aa
aa
aa
aa
aa
aa
aa
aa
aa
aa
aa
aa
aa
aa
aa
aa
aa
aa
aa
aa
aa
aa
aa
aa
aa
aa
aa
aa
aa
aa
aa
aa
aa
aa
aa
aa
aa
aa
aa
aa
aa
aa
aa
aa
aa
aa
aa
aa
aa
aa
aa
aa
aa
aa
aa
aa
aa
"}
(5,1,1) = {"
aa
aa
aa
aa
aa
aa
aa
aa
aa
aa
aa
aa
aa
aa
aa
aa
aa
aa
aa
aa
aa
aa
aa
aa
aa
aa
aa
aa
aa
aa
aa
aa
aa
aa
aa
aa
aa
aa
aa
aa
aa
aa
aa
aa
aa
aa
aa
aa
aa
aa
aa
aa
aa
aa
aa
aa
aa
aa
aa
aa
aa
aa
aa
aa
"}
(6,1,1) = {"
aa
aa
aa
aa
aa
aa
aa
aa
aa
aa
aa
aa
aa
aa
aa
aa
aa
aa
aa
aa
aa
aa
aa
aa
aa
aa
aa
aa
aa
aa
aa
aa
aa
aa
aa
aa
aa
aa
aa
aa
aa
aa
aa
aa
aa
aa
aa
aa
aa
aa
aa
aa
aa
aa
aa
aa
aa
aa
aa
aa
aa
aa
aa
aa
"}
(7,1,1) = {"
aa
aa
aa
aa
aa
aa
aa
aa
aa
aa
aa
aa
aa
aa
aa
aa
aa
aa
aa
aa
aa
aa
aa
aa
aa
aa
aa
aa
aa
aa
aa
aa
aa
aa
aa
aa
aa
aa
aa
aa
aa
aa
aa
aa
aa
aa
aa
aa
aa
aa
aa
aa
aa
aa
aa
aa
aa
aa
aa
aa
aa
aa
aa
aa
"}
(8,1,1) = {"
aa
aa
aa
aa
aa
aa
aa
aa
aa
aa
aa
aa
aa
aa
aa
aa
aa
aa
aa
aa
aa
aa
aa
aa
aa
aa
aa
aa
aa
aa
aa
aa
aa
aa
aa
aa
aa
aa
aa
aa
aa
aa
aa
aa
aa
aa
aa
aa
aa
aa
aa
aa
aa
aa
aa
aa
aa
aa
aa
aa
aa
aa
aa
aa
"}
(9,1,1) = {"
aa
aa
aa
aa
aa
aa
aa
aa
aa
aa
aa
aa
aa
aa
aa
aa
aa
aa
aa
aa
aa
aa
aa
aa
aa
aa
aa
aa
aa
aa
aa
aa
aa
aa
aa
aa
aa
aa
aa
aa
aa
aa
aa
aa
aa
aa
aa
aa
aa
aa
aa
aa
aa
aa
aa
aa
aa
aa
aa
aa
aa
aa
aa
aa
"}
(10,1,1) = {"
aa
aa
aa
aa
aa
aa
aa
aa
aa
aa
aa
aa
aa
aa
aa
aa
aa
aa
aa
aa
aa
aa
aa
aa
aa
aa
aa
aa
aa
aa
aa
aa
aa
aa
aa
aa
aa
aa
aa
aa
aa
aa
aa
aa
aa
aa
aa
aa
aa
aa
aa
aa
aa
aa
aa
aa
aa
aa
aa
aa
aa
aa
aa
aa
"}
(11,1,1) = {"
aa
aa
aa
aa
aa
aa
aa
aa
aa
aa
aa
aa
aa
aa
aa
aa
aa
aa
aa
aa
aa
aa
aa
aa
aa
aa
aa
aa
aa
aa
aa
aa
aa
aa
aa
aa
aa
aa
aa
aa
aa
aa
aa
aa
aa
aa
aa
aa
aa
aa
aa
aa
aa
aa
aa
aa
aa
aa
aa
aa
aa
aa
aa
aa
"}
(12,1,1) = {"
aa
aa
aa
aa
aa
aa
aa
aa
aa
aa
aa
aa
aa
aa
aa
aa
aa
aa
aa
aa
aa
aa
aa
aa
aa
aa
aa
aa
aa
aa
aa
aa
aa
aa
aa
aa
aa
aa
aa
aa
aa
aa
aa
aa
aa
aa
aa
aa
aa
aa
aa
aa
aa
aa
aa
aa
aa
aa
aa
aa
aa
aa
aa
aa
"}
(13,1,1) = {"
aa
aa
aa
aa
aa
aa
aa
aa
aa
aa
aa
aa
aa
aa
aa
aa
aa
aa
aa
aa
aa
aa
aa
aa
aa
aa
aa
aa
aa
aa
aa
aa
aa
aa
aa
aa
aa
aa
aa
aa
aa
aa
aa
aa
aa
aa
aa
aa
aa
aa
aa
aa
aa
aa
aa
aa
aa
aa
aa
aa
aa
aa
aa
aa
"}
(14,1,1) = {"
aa
aa
aa
aa
aa
aa
aa
aa
aa
aa
aa
aa
aa
aa
aa
aa
aa
aa
aa
aa
aa
aa
aa
aa
aa
aa
aa
aa
aa
aa
aa
aa
aa
aa
aa
aa
aa
aa
aa
aa
aa
aa
aa
aa
aa
aa
aa
aa
aa
aa
aa
aa
aa
aa
aa
aa
aa
aa
aa
aa
aa
aa
aa
aa
"}
(15,1,1) = {"
aa
aa
aa
aa
aa
aa
aa
aa
aa
aa
aa
aa
aa
aa
aa
aa
aa
aa
aa
aa
aa
aa
aa
aa
aa
aa
aa
aa
aa
aa
aa
aa
aa
aa
aa
aa
aa
aa
aa
aa
aa
aa
aa
aa
aa
aa
aa
aa
aa
aa
aa
aa
aa
aa
aa
aa
aa
aa
aa
aa
aa
aa
aa
aa
"}
(16,1,1) = {"
aa
aa
aa
aa
aa
aa
aa
aa
aa
aa
aa
aa
aa
aa
aa
aa
aa
aa
aa
aa
aa
aa
aa
aa
ab
ab
ab
ab
ab
ab
aa
aa
aa
aa
aa
ae
ae
ae
ae
ae
ae
aa
aa
aa
aa
aa
aa
aa
aa
aa
aa
aa
aa
aa
aa
aa
aa
aa
aa
aa
aa
aa
aa
aa
"}
(17,1,1) = {"
aa
aa
aa
aa
aa
aa
aa
aa
aa
aa
aa
aa
aa
aa
aa
aa
aa
aa
aa
aa
aa
aa
aa
aa
aK
aK
aK
aK
aK
aK
ae
aa
aa
aa
aa
ae
ae
ae
ae
ae
ae
aa
aa
aa
aa
aa
aa
aa
aa
aa
aa
aa
aa
aa
aa
aa
aa
aa
aa
aa
aa
aa
aa
aa
"}
(18,1,1) = {"
aa
aa
aa
aa
aa
aa
aa
aa
aa
aa
aa
aa
aa
aa
aa
aa
aa
aJ
aJ
aJ
aJ
aJ
aJ
aJ
aK
aK
aK
aK
aK
aK
aK
aK
aK
aK
ae
ae
ae
ae
ae
ae
ae
aa
aa
aa
aa
aa
aa
aa
aa
aa
aa
aa
aa
aa
aa
aa
aa
aa
aa
aa
aa
aa
aa
aa
"}
(19,1,1) = {"
aa
aa
aa
aa
aa
aa
aa
aa
aa
aa
aa
aa
aa
aa
aa
aa
aa
aJ
aJ
aJ
aJ
aJ
aJ
aJ
aK
aK
aK
aK
aK
aK
aK
aK
aK
aK
ae
ae
ae
ae
ae
ae
ae
aa
aa
aa
aa
aa
aa
aa
aa
aa
aa
aa
aa
aa
aa
aa
aa
aa
aa
aa
aa
aa
aa
aa
"}
(20,1,1) = {"
aa
aa
aa
aa
aa
aa
aa
aa
aa
aa
aa
aa
aa
aa
aa
aa
aa
aJ
aK
ac
ac
ac
ac
ac
ac
ac
af
af
aF
aF
aF
aF
aK
aF
aF
aF
aF
aF
ae
ae
ae
ae
ae
ae
ae
ae
ae
aa
aa
aa
aa
aa
aa
aa
aa
aa
aa
aa
aa
aa
aa
aa
aa
aa
"}
(21,1,1) = {"
aa
aa
aa
aa
aa
aa
aa
aa
aa
aa
aa
aa
aa
aa
aa
aa
aa
aJ
aK
ac
ac
ac
ac
ac
ac
ac
af
af
aF
aF
aF
aF
aF
aF
aF
aF
aF
aF
ae
ae
ae
ae
ae
ae
ae
ae
ae
aa
aa
aa
aa
aa
aa
aa
aa
aa
aa
aa
aa
aa
aa
aa
aa
aa
"}
(22,1,1) = {"
aa
aa
aa
aa
aa
aa
aa
aa
aa
aa
aa
aa
aa
aa
aa
aa
ab
aK
aK
ac
ac
ac
ac
ac
ac
ac
af
af
aF
aF
aF
aF
aF
aF
aF
aF
aF
aF
ae
ae
ae
ae
ae
ae
ae
ae
ae
ae
ae
aa
aa
aa
aa
aa
aa
aa
aa
aa
aa
aa
aa
aa
aa
aa
"}
(23,1,1) = {"
aa
aa
aa
aa
aa
aa
aa
aa
aa
aa
aa
aa
aa
aa
aa
aa
ab
aK
aK
ac
ac
ac
ac
ac
ac
ac
af
af
aF
aF
aF
aF
aF
aF
aF
aF
aF
aF
ae
ae
ae
ae
ae
ae
ae
ae
ae
ae
ae
aa
aa
aa
aa
aa
aa
aa
aa
aa
aa
aa
aa
aa
aa
aa
"}
(24,1,1) = {"
aa
aa
aa
aa
aa
aa
aa
aa
aa
aa
aa
aa
aa
aa
aa
aa
ab
aK
aK
ac
aK
ac
ac
ac
ac
ac
af
af
aF
aF
aF
aF
aF
aF
aF
aF
aF
aF
ae
ae
ae
ae
ae
ae
ae
ae
ae
ae
ae
aa
aa
aa
aa
aa
aa
aa
aa
aa
aa
aa
aa
aa
aa
aa
"}
(25,1,1) = {"
aa
aa
aa
aa
aa
aa
aa
aa
aa
aa
aa
aa
aa
aa
aa
aa
ab
aK
aK
aK
aK
aK
aK
aK
aK
aS
ad
ad
aG
aG
aG
aG
aG
aG
aG
aG
aG
aG
ad
ad
ad
ae
ae
ae
ae
ae
ae
ae
ae
aa
aa
aa
aa
aa
aa
aa
aa
aa
aa
aa
aa
aa
aa
aa
"}
(26,1,1) = {"
aa
aa
aa
aa
aa
aa
aa
aa
ab
ab
ab
ab
ab
ab
ab
ab
ab
aK
aK
aD
aK
aD
aD
aD
aD
aE
ag
ag
ag
ag
ag
ag
aq
ag
ag
ag
ag
ag
ag
ag
ad
ae
ae
ae
ae
ae
ae
ae
ae
ae
ae
ae
ae
ae
ae
ae
aa
aa
aa
aa
aa
aa
aa
aa
"}
(27,1,1) = {"
aa
aa
aa
aa
aa
aa
aa
aa
ab
ab
ab
ab
ab
ab
ab
ab
ab
ab
ab
aD
aD
aD
aD
aD
aD
aE
ag
ag
ag
ag
ag
ag
ag
ag
ag
ag
ag
ag
ag
ag
ad
ae
ae
ae
ae
ae
ae
ae
ae
ae
ae
ae
ae
ae
ae
ae
aa
aa
aa
aa
aa
aa
aa
aa
"}
(28,1,1) = {"
aa
aa
aa
aa
aa
aa
aa
aa
ab
ab
ab
ab
ab
ab
ab
ab
ab
ab
ab
aD
aD
aD
aD
aD
aD
aE
ag
ag
ad
ad
ad
ad
ad
ad
ad
ad
ad
ad
ag
ag
ad
ae
ae
ae
ae
ae
ae
ae
ae
ae
ae
ae
ae
ae
ae
ae
aa
aa
aa
aa
aa
aa
aa
aa
"}
(29,1,1) = {"
aa
aa
aa
aa
aa
aa
aa
aa
ab
ab
ab
ab
ab
ab
ab
ab
ab
ab
ab
aD
aD
aD
aD
aD
aD
aE
ag
ag
ad
ai
am
am
am
am
am
as
az
ad
ag
ag
aN
aO
aO
aO
aO
ae
ae
ae
ae
ae
ae
ae
ae
ae
ae
ae
aa
aa
aa
aa
aa
aa
aa
aa
"}
(30,1,1) = {"
aa
aa
aa
aa
aa
aa
aa
aa
aa
aa
aa
aa
aa
aa
aa
aa
aa
aa
ab
aD
aD
aD
aD
aD
aD
aE
ag
ag
ad
aj
an
an
an
an
an
at
aA
ad
ag
ag
aN
aO
aO
aO
aO
ae
ae
ae
aa
aa
aa
aa
aa
aa
aa
aa
aa
aa
aa
aa
aa
aa
aa
aa
"}
(31,1,1) = {"
aa
aa
aa
aa
aa
aa
aa
aa
aa
aa
aa
aa
aa
aa
aa
aa
aa
aa
ab
aD
aD
aD
aD
aD
aD
aE
ag
ag
ad
aj
an
an
an
an
an
au
aA
ad
ag
ag
aN
aO
aO
aO
aO
ae
ae
ae
aa
aa
aa
aa
aa
aa
aa
aa
aa
aa
aa
aa
aa
aa
aa
aa
"}
(32,1,1) = {"
aa
aa
aa
aa
aa
aa
aa
aa
aa
aa
aa
aa
aa
aa
aa
aa
aa
aa
ab
aD
aD
aD
aD
aD
aD
aE
ah
ag
ad
ak
an
an
an
an
an
av
aV
ad
ag
aM
aN
aO
aO
aO
aO
ae
ae
ae
aa
aa
aa
aa
aa
aa
aa
aa
aa
aa
aa
aa
aa
aa
aa
aa
"}
(33,1,1) = {"
aa
aa
aa
aa
aa
aa
aa
aa
aa
aa
aa
aa
aa
aa
aa
aa
aa
aa
ab
aD
aD
aD
aD
aD
aD
aE
ag
ag
ad
aj
an
an
an
an
an
aw
aW
ad
ag
ag
ad
ae
ae
ae
ae
ae
ae
ae
aa
aa
aa
aa
aa
aa
aa
aa
aa
aa
aa
aa
aa
aa
aa
aa
"}
(34,1,1) = {"
aa
aa
aa
aa
aa
aa
aa
aa
aa
aa
aa
aa
aa
aa
aa
aa
aa
aa
ab
aD
aD
aD
aD
aD
aD
aE
ag
ag
ad
aj
an
an
an
an
an
ax
aW
ad
ag
ag
ad
ae
ae
ae
ae
ae
ae
ae
aa
aa
aa
aa
aa
aa
aa
aa
aa
aa
aa
aa
aa
aa
aa
aa
"}
(35,1,1) = {"
aa
aa
aa
aa
aa
aa
aa
aa
aa
aa
aa
aa
aa
aa
aa
aa
aa
aa
ab
aD
aD
aD
aD
aD
aD
aE
ag
ag
ad
al
ao
ap
ay
aC
aL
aU
aX
ad
ag
ag
ad
ae
ae
ae
ae
ae
ae
ae
aa
aa
aa
aa
aa
aa
aa
aa
aa
aa
aa
aa
aa
aa
aa
aa
"}
(36,1,1) = {"
aa
aa
aa
aa
aa
aa
aa
aa
aa
aa
aa
aa
aa
aa
aa
aa
aa
aa
ab
aD
aD
aD
aD
aD
aD
aE
ag
ag
ad
ad
ad
ag
aB
ag
ad
ad
ad
ad
ag
ag
ad
ae
ae
ae
ae
ae
ae
ae
aa
aa
aa
aa
aa
aa
aa
aa
aa
aa
aa
aa
aa
aa
aa
aa
"}
(37,1,1) = {"
aa
aa
aa
aa
aa
aa
aa
aa
aa
aa
aa
aa
aa
aa
aa
aa
aa
aa
ab
aD
aD
aD
aD
aD
aD
aE
ag
ag
ag
ag
ag
aZ
aY
ba
ag
ag
ag
ag
ag
ag
ad
ae
ae
ae
ae
ae
ae
ae
aa
aa
aa
aa
aa
aa
aa
aa
aa
aa
aa
aa
aa
aa
aa
aa
"}
(38,1,1) = {"
aa
aa
aa
aa
aa
aa
aa
aa
aa
aa
aa
aa
aa
aa
aa
aa
aa
aa
ab
aD
aD
aD
aD
aD
aD
aE
ag
ag
ag
ag
ag
ag
ar
ag
ag
ag
ag
ag
ag
ag
ad
ae
ae
ae
ae
ae
ae
aa
aa
aa
aa
aa
aa
aa
aa
aa
aa
aa
aa
aa
aa
aa
aa
aa
"}
(39,1,1) = {"
aa
aa
aa
aa
aa
aa
aa
aa
aa
aa
aa
aa
aa
aa
aa
aa
ab
ab
ab
ab
ab
ab
ab
aR
aR
aT
aT
aP
aP
aP
aP
aP
ad
aT
ad
aH
aH
aH
aH
aH
ad
ae
ae
ae
ae
ae
ae
ae
ae
aa
aa
aa
aa
aa
aa
aa
aa
aa
aa
aa
aa
aa
aa
aa
"}
(40,1,1) = {"
aa
aa
aa
aa
aa
aa
aa
aa
aa
aa
aa
aa
aa
aa
aa
aa
ab
ab
ab
ab
ab
ab
ab
aR
aR
aR
aR
aQ
aQ
aQ
aQ
aQ
aR
aR
aR
aI
aI
aI
aI
aI
ae
ae
ae
ae
ae
ae
ae
ae
ae
aa
aa
aa
aa
aa
aa
aa
aa
aa
aa
aa
aa
aa
aa
aa
"}
(41,1,1) = {"
aa
aa
aa
aa
aa
aa
aa
aa
aa
aa
aa
aa
aa
aa
aa
aa
ab
ab
ab
ab
ab
ab
ab
aR
aR
aR
aR
aQ
aQ
aQ
aQ
aQ
aR
aR
aR
aI
aI
aI
aI
aI
ae
ae
ae
ae
ae
ae
ae
ae
ae
aa
aa
aa
aa
aa
aa
aa
aa
aa
aa
aa
aa
aa
aa
aa
"}
(42,1,1) = {"
aa
aa
aa
aa
aa
aa
aa
aa
aa
aa
aa
aa
aa
aa
aa
aa
ab
ab
ab
ab
ab
ab
ab
ab
ab
aR
aR
aQ
aQ
aQ
aQ
aQ
aR
aR
aR
aI
aI
aI
aI
aI
ae
ae
ae
ae
ae
ae
ae
ae
ae
aa
aa
aa
aa
aa
aa
aa
aa
aa
aa
aa
aa
aa
aa
aa
"}
(43,1,1) = {"
aa
aa
aa
aa
aa
aa
aa
aa
aa
aa
aa
aa
aa
aa
aa
aa
aa
aa
ab
ab
ab
ab
ab
ab
ab
aR
aR
aQ
aQ
aQ
aQ
aQ
aR
aR
ae
aI
aI
aI
aI
aI
ae
ae
ae
ae
ae
ae
ae
aa
aa
aa
aa
aa
aa
aa
aa
aa
aa
aa
aa
aa
aa
aa
aa
aa
"}
(44,1,1) = {"
aa
aa
aa
aa
aa
aa
aa
aa
aa
aa
aa
aa
aa
aa
aa
aa
aa
aa
ab
ab
ab
ab
ab
ab
ab
aR
aR
aQ
aQ
aR
aQ
aQ
aR
aR
ae
ae
ae
ae
ae
ae
ae
ae
ae
ae
ae
ae
ae
aa
aa
aa
aa
aa
aa
aa
aa
aa
aa
aa
aa
aa
aa
aa
aa
aa
"}
(45,1,1) = {"
aa
aa
aa
aa
aa
aa
aa
aa
aa
aa
aa
aa
aa
aa
aa
aa
aa
aa
aa
aa
aa
aa
aa
aa
ab
aR
aR
aR
aR
aR
aR
aR
aR
aR
ae
ae
ae
ae
ae
ae
ae
aa
aa
aa
aa
aa
aa
aa
aa
aa
aa
aa
aa
aa
aa
aa
aa
aa
aa
aa
aa
aa
aa
aa
"}
(46,1,1) = {"
aa
aa
aa
aa
aa
aa
aa
aa
aa
aa
aa
aa
aa
aa
aa
aa
aa
aa
aa
aa
aa
aa
aa
aa
ab
aR
aR
aR
aR
aR
aR
aR
aR
aR
ae
ae
ae
ae
ae
ae
ae
aa
aa
aa
aa
aa
aa
aa
aa
aa
aa
aa
aa
aa
aa
aa
aa
aa
aa
aa
aa
aa
aa
aa
"}
(47,1,1) = {"
aa
aa
aa
aa
aa
aa
aa
aa
aa
aa
aa
aa
aa
aa
aa
aa
aa
aa
aa
aa
aa
aa
aa
aa
ab
ab
ab
ab
ab
ab
aa
aa
aa
aa
aa
ae
ae
ae
ae
ae
ae
aa
aa
aa
aa
aa
aa
aa
aa
aa
aa
aa
aa
aa
aa
aa
aa
aa
aa
aa
aa
aa
aa
aa
"}
(48,1,1) = {"
aa
aa
aa
aa
aa
aa
aa
aa
aa
aa
aa
aa
aa
aa
aa
aa
aa
aa
aa
aa
aa
aa
aa
aa
ab
ab
ab
ab
ab
ab
aa
aa
aa
aa
aa
ae
ae
ae
ae
ae
ae
aa
aa
aa
aa
aa
aa
aa
aa
aa
aa
aa
aa
aa
aa
aa
aa
aa
aa
aa
aa
aa
aa
aa
"}
(49,1,1) = {"
aa
aa
aa
aa
aa
aa
aa
aa
aa
aa
aa
aa
aa
aa
aa
aa
aa
aa
aa
aa
aa
aa
aa
aa
aa
aa
aa
aa
aa
aa
aa
aa
aa
aa
aa
aa
aa
aa
aa
aa
aa
aa
aa
aa
aa
aa
aa
aa
aa
aa
aa
aa
aa
aa
aa
aa
aa
aa
aa
aa
aa
aa
aa
aa
"}
(50,1,1) = {"
aa
aa
aa
aa
aa
aa
aa
aa
aa
aa
aa
aa
aa
aa
aa
aa
aa
aa
aa
aa
aa
aa
aa
aa
aa
aa
aa
aa
aa
aa
aa
aa
aa
aa
aa
aa
aa
aa
aa
aa
aa
aa
aa
aa
aa
aa
aa
aa
aa
aa
aa
aa
aa
aa
aa
aa
aa
aa
aa
aa
aa
aa
aa
aa
"}
(51,1,1) = {"
aa
aa
aa
aa
aa
aa
aa
aa
aa
aa
aa
aa
aa
aa
aa
aa
aa
aa
aa
aa
aa
aa
aa
aa
aa
aa
aa
aa
aa
aa
aa
aa
aa
aa
aa
aa
aa
aa
aa
aa
aa
aa
aa
aa
aa
aa
aa
aa
aa
aa
aa
aa
aa
aa
aa
aa
aa
aa
aa
aa
aa
aa
aa
aa
"}
(52,1,1) = {"
aa
aa
aa
aa
aa
aa
aa
aa
aa
aa
aa
aa
aa
aa
aa
aa
aa
aa
aa
aa
aa
aa
aa
aa
aa
aa
aa
aa
aa
aa
aa
aa
aa
aa
aa
aa
aa
aa
aa
aa
aa
aa
aa
aa
aa
aa
aa
aa
aa
aa
aa
aa
aa
aa
aa
aa
aa
aa
aa
aa
aa
aa
aa
aa
"}
(53,1,1) = {"
aa
aa
aa
aa
aa
aa
aa
aa
aa
aa
aa
aa
aa
aa
aa
aa
aa
aa
aa
aa
aa
aa
aa
aa
aa
aa
aa
aa
aa
aa
aa
aa
aa
aa
aa
aa
aa
aa
aa
aa
aa
aa
aa
aa
aa
aa
aa
aa
aa
aa
aa
aa
aa
aa
aa
aa
aa
aa
aa
aa
aa
aa
aa
aa
"}
(54,1,1) = {"
aa
aa
aa
aa
aa
aa
aa
aa
aa
aa
aa
aa
aa
aa
aa
aa
aa
aa
aa
aa
aa
aa
aa
aa
aa
aa
aa
aa
aa
aa
aa
aa
aa
aa
aa
aa
aa
aa
aa
aa
aa
aa
aa
aa
aa
aa
aa
aa
aa
aa
aa
aa
aa
aa
aa
aa
aa
aa
aa
aa
aa
aa
aa
aa
"}
(55,1,1) = {"
aa
aa
aa
aa
aa
aa
aa
aa
aa
aa
aa
aa
aa
aa
aa
aa
aa
aa
aa
aa
aa
aa
aa
aa
aa
aa
aa
aa
aa
aa
aa
aa
aa
aa
aa
aa
aa
aa
aa
aa
aa
aa
aa
aa
aa
aa
aa
aa
aa
aa
aa
aa
aa
aa
aa
aa
aa
aa
aa
aa
aa
aa
aa
aa
"}
(56,1,1) = {"
aa
aa
aa
aa
aa
aa
aa
aa
aa
aa
aa
aa
aa
aa
aa
aa
aa
aa
aa
aa
aa
aa
aa
aa
aa
aa
aa
aa
aa
aa
aa
aa
aa
aa
aa
aa
aa
aa
aa
aa
aa
aa
aa
aa
aa
aa
aa
aa
aa
aa
aa
aa
aa
aa
aa
aa
aa
aa
aa
aa
aa
aa
aa
aa
"}
(57,1,1) = {"
aa
aa
aa
aa
aa
aa
aa
aa
aa
aa
aa
aa
aa
aa
aa
aa
aa
aa
aa
aa
aa
aa
aa
aa
aa
aa
aa
aa
aa
aa
aa
aa
aa
aa
aa
aa
aa
aa
aa
aa
aa
aa
aa
aa
aa
aa
aa
aa
aa
aa
aa
aa
aa
aa
aa
aa
aa
aa
aa
aa
aa
aa
aa
aa
"}
(58,1,1) = {"
aa
aa
aa
aa
aa
aa
aa
aa
aa
aa
aa
aa
aa
aa
aa
aa
aa
aa
aa
aa
aa
aa
aa
aa
aa
aa
aa
aa
aa
aa
aa
aa
aa
aa
aa
aa
aa
aa
aa
aa
aa
aa
aa
aa
aa
aa
aa
aa
aa
aa
aa
aa
aa
aa
aa
aa
aa
aa
aa
aa
aa
aa
aa
aa
"}
(59,1,1) = {"
aa
aa
aa
aa
aa
aa
aa
aa
aa
aa
aa
aa
aa
aa
aa
aa
aa
aa
aa
aa
aa
aa
aa
aa
aa
aa
aa
aa
aa
aa
aa
aa
aa
aa
aa
aa
aa
aa
aa
aa
aa
aa
aa
aa
aa
aa
aa
aa
aa
aa
aa
aa
aa
aa
aa
aa
aa
aa
aa
aa
aa
aa
aa
aa
"}
(60,1,1) = {"
aa
aa
aa
aa
aa
aa
aa
aa
aa
aa
aa
aa
aa
aa
aa
aa
aa
aa
aa
aa
aa
aa
aa
aa
aa
aa
aa
aa
aa
aa
aa
aa
aa
aa
aa
aa
aa
aa
aa
aa
aa
aa
aa
aa
aa
aa
aa
aa
aa
aa
aa
aa
aa
aa
aa
aa
aa
aa
aa
aa
aa
aa
aa
aa
"}
(61,1,1) = {"
aa
aa
aa
aa
aa
aa
aa
aa
aa
aa
aa
aa
aa
aa
aa
aa
aa
aa
aa
aa
aa
aa
aa
aa
aa
aa
aa
aa
aa
aa
aa
aa
aa
aa
aa
aa
aa
aa
aa
aa
aa
aa
aa
aa
aa
aa
aa
aa
aa
aa
aa
aa
aa
aa
aa
aa
aa
aa
aa
aa
aa
aa
aa
aa
"}
(62,1,1) = {"
aa
aa
aa
aa
aa
aa
aa
aa
aa
aa
aa
aa
aa
aa
aa
aa
aa
aa
aa
aa
aa
aa
aa
aa
aa
aa
aa
aa
aa
aa
aa
aa
aa
aa
aa
aa
aa
aa
aa
aa
aa
aa
aa
aa
aa
aa
aa
aa
aa
aa
aa
aa
aa
aa
aa
aa
aa
aa
aa
aa
aa
aa
aa
aa
"}
(63,1,1) = {"
aa
aa
aa
aa
aa
aa
aa
aa
aa
aa
aa
aa
aa
aa
aa
aa
aa
aa
aa
aa
aa
aa
aa
aa
aa
aa
aa
aa
aa
aa
aa
aa
aa
aa
aa
aa
aa
aa
aa
aa
aa
aa
aa
aa
aa
aa
aa
aa
aa
aa
aa
aa
aa
aa
aa
aa
aa
aa
aa
aa
aa
aa
aa
aa
"}
(64,1,1) = {"
aa
aa
aa
aa
aa
aa
aa
aa
aa
aa
aa
aa
aa
aa
aa
aa
aa
aa
aa
aa
aa
aa
aa
aa
aa
aa
aa
aa
aa
aa
aa
aa
aa
aa
aa
aa
aa
aa
aa
aa
aa
aa
aa
aa
aa
aa
aa
aa
aa
aa
aa
aa
aa
aa
aa
aa
aa
aa
aa
aa
aa
aa
aa
aa
"}
