//MAP CONVERTED BY dmm2tgm.py THIS HEADER COMMENT PREVENTS RECONVERSION, DO NOT REMOVE
"aa" = (
/turf/space,
/area/space)
"ab" = (
/turf/simulated/wall,
/area/shelltooth/level_five/matriarch)
"ac" = (
/turf/simulated/floor/tiled,
/area/shelltooth/level_five/matriarch)
"ad" = (
/turf/simulated/wall,
/area/shelltooth/level_five/attend)
"ae" = (
/turf/simulated/floor/tiled,
/area/shelltooth/level_five/attend)
"af" = (
/obj/machinery/light{
	icon_state = "tube_map";
	dir = 1
	},
/turf/simulated/floor/tiled,
/area/shelltooth/level_five/attend)
"ag" = (
/turf/simulated/wall,
/area/shelltooth/level_five/hall)
"ah" = (
/obj/machinery/door/airlock/command,
/turf/simulated/floor/tiled,
/area/shelltooth/level_five/matriarch)
"ai" = (
/obj/effect/landmark/test/safe_turf,
/obj/machinery/atmospherics/unary/vent_pump/on,
/turf/simulated/floor/tiled,
/area/shelltooth/level_five/attend)
"aj" = (
/obj/machinery/door/airlock/command,
/turf/simulated/floor/tiled,
/area/shelltooth/level_five/attend)
"ak" = (
/turf/simulated/floor/tiled,
/area/shelltooth/level_five/hall)
"al" = (
/obj/machinery/light,
/turf/simulated/floor/tiled,
/area/shelltooth/level_five/attend)
"am" = (
/obj/effect/floor_decal/industrial/warning/corner,
/obj/structure/catwalk,
/turf/simulated/floor,
/area/shelltooth/level_five/hall)
"an" = (
/obj/structure/railing/mapped,
/obj/effect/floor_decal/industrial/warning,
/obj/structure/catwalk,
/turf/simulated/floor,
/area/shelltooth/level_five/hall)
"ao" = (
/obj/structure/railing/mapped,
/obj/effect/floor_decal/industrial/warning,
/obj/structure/catwalk,
/obj/machinery/light{
	icon_state = "tube_map";
	dir = 1
	},
/turf/simulated/floor,
/area/shelltooth/level_five/hall)
"ap" = (
/obj/effect/floor_decal/industrial/warning/corner{
	icon_state = "stripecorner";
	dir = 8
	},
/obj/structure/catwalk,
/turf/simulated/floor,
/area/shelltooth/level_five/hall)
"aq" = (
/obj/structure/railing/mapped{
	icon_state = "railing0-1";
	dir = 4
	},
/obj/effect/floor_decal/industrial/warning{
	icon_state = "stripe";
	dir = 4
	},
/obj/structure/catwalk,
/turf/simulated/floor,
/area/shelltooth/level_five/hall)
"ar" = (
/turf/simulated/open,
/area/shelltooth/level_five/hall)
"as" = (
/obj/structure/railing/mapped{
	icon_state = "railing0-1";
	dir = 8
	},
/obj/effect/floor_decal/industrial/warning{
	icon_state = "stripe";
	dir = 8
	},
/obj/structure/catwalk,
/turf/simulated/floor,
/area/shelltooth/level_five/hall)
"at" = (
/obj/effect/floor_decal/industrial/warning{
	icon_state = "stripe";
	dir = 8
	},
/obj/structure/catwalk,
/turf/simulated/floor,
/area/shelltooth/level_five/hall)
"au" = (
/obj/machinery/light{
	icon_state = "tube_map";
	dir = 8
	},
/turf/simulated/floor/tiled,
/area/shelltooth/level_five/matriarch)
"av" = (
/obj/machinery/atmospherics/unary/vent_pump/on{
	dir = 4;
	level = 2
	},
/turf/simulated/floor/tiled,
/area/shelltooth/level_five/matriarch)
"aw" = (
/obj/effect/landmark/map_data{
	height = 5
	},
/turf/space,
/area/space)
"ax" = (
/obj/effect/landmark/test/space_turf,
/turf/space,
/area/space)
"ay" = (
/obj/effect/floor_decal/industrial/warning{
	icon_state = "stripe";
	dir = 4
	},
/obj/structure/catwalk,
/turf/simulated/floor,
/area/shelltooth/level_five/hall)
"az" = (
/obj/structure/railing/mapped{
	icon_state = "railing0-1";
	dir = 1
	},
/obj/structure/ladder,
/turf/simulated/open,
/area/shelltooth/level_five/hall)
"aA" = (
/obj/structure/lattice,
/obj/structure/railing/mapped{
	icon_state = "railing0-1";
	dir = 1
	},
/turf/simulated/open,
/area/shelltooth/level_five/hall)
"aB" = (
/obj/structure/railing/mapped{
	icon_state = "railing0-1";
	dir = 1
	},
/obj/structure/lattice,
/obj/structure/cable{
	icon_state = "2-4"
	},
/obj/machinery/atmospherics/pipe/simple/hidden/scrubbers{
	icon_state = "intact-scrubbers";
	dir = 6
	},
/obj/machinery/atmospherics/pipe/simple/hidden/supply{
	icon_state = "intact-supply";
	dir = 6;
	pixel_y = 0
	},
/turf/simulated/open,
/area/shelltooth/level_five/hall)
"aC" = (
/obj/structure/railing/mapped{
	icon_state = "railing0-1";
	dir = 1
	},
/obj/structure/lattice,
/obj/machinery/atmospherics/pipe/zpipe/down/scrubbers{
	icon_state = "down-scrubbers";
	dir = 8
	},
/obj/machinery/atmospherics/pipe/zpipe/down/supply{
	icon_state = "down-supply";
	dir = 8
	},
/obj/structure/cable{
	icon_state = "32-8"
	},
/turf/simulated/open,
/area/shelltooth/level_five/hall)
"aD" = (
/obj/structure/railing/mapped{
	icon_state = "railing0-1";
	dir = 1
	},
/obj/structure/lattice,
/turf/simulated/open,
/area/shelltooth/level_five/hall)
"aE" = (
/obj/machinery/atmospherics/pipe/simple/hidden/supply{
	icon_state = "intact-supply";
	dir = 6;
	pixel_y = 0
	},
/obj/machinery/atmospherics/pipe/simple/hidden/scrubbers{
	icon_state = "intact-scrubbers";
	dir = 6
	},
/turf/simulated/floor/tiled,
/area/shelltooth/level_five/matriarch)
"aF" = (
/obj/effect/floor_decal/industrial/warning/corner{
	icon_state = "stripecorner";
	dir = 4
	},
/obj/structure/catwalk,
/turf/simulated/floor,
/area/shelltooth/level_five/hall)
"aG" = (
/obj/effect/floor_decal/industrial/warning{
	icon_state = "stripe";
	dir = 1
	},
/obj/structure/catwalk,
/turf/simulated/floor,
/area/shelltooth/level_five/hall)
"aH" = (
/obj/machinery/atmospherics/pipe/simple/hidden/supply{
	dir = 4
	},
/obj/machinery/atmospherics/pipe/simple/hidden/scrubbers{
	dir = 4
	},
/turf/simulated/floor/tiled,
/area/shelltooth/level_five/matriarch)
"aI" = (
/obj/machinery/door/airlock/command,
/obj/machinery/atmospherics/pipe/simple/hidden/supply{
	dir = 4
	},
/obj/machinery/atmospherics/pipe/simple/hidden/scrubbers{
	dir = 4
	},
/turf/simulated/floor/tiled,
/area/shelltooth/level_five/matriarch)
"aJ" = (
/obj/machinery/atmospherics/pipe/simple/hidden/supply{
	dir = 4
	},
/obj/machinery/atmospherics/pipe/manifold/hidden/scrubbers,
/turf/simulated/floor/tiled,
/area/shelltooth/level_five/attend)
"aK" = (
/turf/simulated/wall,
/area/shelltooth/level_five/heads)
"aL" = (
/turf/simulated/floor/tiled,
/area/shelltooth/level_five/heads)
"aM" = (
/obj/machinery/light{
	icon_state = "tube_map";
	dir = 1
	},
/turf/simulated/floor/tiled,
/area/shelltooth/level_five/heads)
"aN" = (
/obj/machinery/light,
/turf/simulated/floor/tiled,
/area/shelltooth/level_five/heads)
"aO" = (
/turf/space,
/area/shelltooth/maint/level_five/north)
"aP" = (
/turf/simulated/wall,
/area/shelltooth/maint/level_five/north)
"aQ" = (
/turf/space,
/area/shelltooth/level_five/comms)
"aR" = (
/turf/space,
/area/shelltooth/level_five/hall)
"aS" = (
/turf/space,
/area/shelltooth/maint/level_five/east)
"aT" = (
/turf/simulated/wall,
/area/shelltooth/maint/level_five/east)
"aU" = (
/obj/machinery/atmospherics/pipe/simple/hidden/supply{
	dir = 4
	},
/obj/machinery/atmospherics/pipe/simple/hidden/scrubbers{
	dir = 4
	},
/turf/simulated/floor/tiled,
/area/shelltooth/level_five/attend)
"aV" = (
/obj/machinery/atmospherics/pipe/simple/hidden/supply{
	dir = 4
	},
/turf/simulated/floor/tiled,
/area/shelltooth/level_five/hall)
"aW" = (
/obj/machinery/atmospherics/pipe/simple/hidden/scrubbers{
	dir = 4
	},
/obj/machinery/atmospherics/pipe/manifold/hidden/supply,
/turf/simulated/floor/tiled,
/area/shelltooth/level_five/attend)
"aX" = (
/obj/machinery/atmospherics/pipe/simple/hidden/scrubbers{
	icon_state = "intact-scrubbers";
	dir = 1
	},
/obj/machinery/atmospherics/pipe/manifold/hidden/supply{
	icon_state = "map-supply";
	dir = 4
	},
/turf/simulated/floor/tiled,
/area/shelltooth/level_five/matriarch)
"aY" = (
/obj/machinery/door/airlock/command,
/obj/machinery/atmospherics/pipe/simple/hidden/supply{
	dir = 4
	},
/obj/machinery/atmospherics/pipe/simple/hidden/scrubbers{
	dir = 4
	},
/turf/simulated/floor/tiled,
/area/shelltooth/level_five/attend)
"aZ" = (
/obj/machinery/atmospherics/pipe/simple/hidden/supply{
	dir = 4
	},
/obj/machinery/atmospherics/pipe/simple/hidden/scrubbers{
	dir = 4
	},
/turf/simulated/floor/tiled,
/area/shelltooth/level_five/hall)
"ba" = (
/obj/machinery/atmospherics/pipe/simple/hidden/supply{
	icon_state = "intact-supply";
	dir = 10
	},
/obj/machinery/atmospherics/pipe/simple/hidden/scrubbers{
	dir = 10
	},
/turf/simulated/floor/tiled,
/area/shelltooth/level_five/hall)
"bb" = (
/obj/machinery/atmospherics/pipe/simple/hidden/supply,
/obj/machinery/atmospherics/pipe/simple/hidden/scrubbers{
	icon_state = "intact-scrubbers";
	dir = 1
	},
/turf/simulated/floor/tiled,
/area/shelltooth/level_five/matriarch)
"bc" = (
/obj/machinery/atmospherics/pipe/simple/hidden/supply,
/obj/machinery/atmospherics/pipe/simple/hidden/scrubbers{
	icon_state = "intact-scrubbers";
	dir = 1
	},
/turf/simulated/floor/tiled,
/area/shelltooth/level_five/hall)
"bd" = (
/obj/machinery/atmospherics/pipe/manifold/hidden/scrubbers{
	icon_state = "map-scrubbers";
	dir = 4
	},
/obj/machinery/atmospherics/pipe/manifold/hidden/supply,
/turf/simulated/floor/tiled,
/area/shelltooth/level_five/hall)
"be" = (
/obj/effect/floor_decal/industrial/warning{
	icon_state = "stripe";
	dir = 8
	},
/obj/structure/catwalk,
/obj/machinery/atmospherics/pipe/simple/hidden/supply{
	icon_state = "intact-supply";
	dir = 6;
	pixel_y = 0
	},
/obj/machinery/atmospherics/pipe/simple/hidden/scrubbers{
	icon_state = "intact-scrubbers";
	dir = 6
	},
/turf/simulated/floor,
/area/shelltooth/level_five/hall)
"bf" = (
/obj/effect/floor_decal/industrial/warning{
	icon_state = "stripe";
	dir = 8
	},
/obj/structure/catwalk,
/obj/machinery/atmospherics/pipe/simple/hidden/supply,
/obj/machinery/atmospherics/pipe/simple/hidden/scrubbers{
	icon_state = "intact-scrubbers";
	dir = 1
	},
/turf/simulated/floor,
/area/shelltooth/level_five/hall)
"bg" = (
/obj/structure/railing/mapped{
	icon_state = "railing0-1";
	dir = 8
	},
/obj/effect/floor_decal/industrial/warning{
	icon_state = "stripe";
	dir = 8
	},
/obj/structure/catwalk,
/obj/machinery/atmospherics/pipe/simple/hidden/supply,
/obj/machinery/atmospherics/pipe/simple/hidden/scrubbers{
	icon_state = "intact-scrubbers";
	dir = 1
	},
/turf/simulated/floor,
/area/shelltooth/level_five/hall)
"bh" = (
/obj/effect/floor_decal/industrial/warning/corner{
	icon_state = "stripecorner";
	dir = 1
	},
/obj/effect/floor_decal/industrial/warning{
	icon_state = "stripe";
	dir = 8
	},
/obj/structure/catwalk,
/obj/machinery/atmospherics/pipe/simple/hidden/supply,
/obj/machinery/atmospherics/pipe/simple/hidden/scrubbers{
	icon_state = "intact-scrubbers";
	dir = 1
	},
/turf/simulated/floor,
/area/shelltooth/level_five/hall)
"bi" = (
/obj/machinery/door/airlock/command,
/obj/machinery/atmospherics/pipe/simple/hidden/supply,
/obj/machinery/atmospherics/pipe/simple/hidden/scrubbers{
	icon_state = "intact-scrubbers";
	dir = 1
	},
/turf/simulated/floor/tiled,
/area/shelltooth/level_five/matriarch)
"bj" = (
/obj/effect/floor_decal/industrial/warning{
	icon_state = "stripe";
	dir = 1
	},
/obj/machinery/atmospherics/pipe/cap/hidden/scrubbers{
	icon_state = "cap-scrubbers";
	dir = 1
	},
/obj/machinery/atmospherics/pipe/cap/hidden/supply{
	icon_state = "cap-supply";
	dir = 1
	},
/obj/structure/cable{
	d1 = 1;
	d2 = 4;
	icon_state = "1-4"
	},
/obj/structure/catwalk,
/obj/machinery/light,
/obj/machinery/atmospherics/pipe/simple/hidden/supply{
	icon_state = "intact-supply";
	dir = 5
	},
/obj/machinery/atmospherics/pipe/simple/hidden/scrubbers{
	dir = 5
	},
/turf/simulated/floor,
/area/shelltooth/level_five/hall)
"bk" = (
/obj/machinery/atmospherics/pipe/simple/hidden/supply{
	icon_state = "intact-supply";
	dir = 8
	},
/turf/simulated/floor/tiled,
/area/shelltooth/level_five/heads)
"bl" = (
/obj/effect/floor_decal/industrial/warning{
	icon_state = "stripe";
	dir = 1
	},
/obj/structure/cable{
	icon_state = "4-8"
	},
/obj/structure/catwalk,
/obj/machinery/atmospherics/pipe/simple/hidden/supply{
	dir = 4
	},
/obj/machinery/atmospherics/pipe/simple/hidden/scrubbers{
	dir = 4
	},
/turf/simulated/floor,
/area/shelltooth/level_five/hall)
"bm" = (
/obj/effect/floor_decal/industrial/warning/corner{
	icon_state = "stripecorner";
	dir = 1
	},
/obj/structure/cable{
	d2 = 8;
	icon_state = "0-8"
	},
/obj/machinery/power/apc/high{
	icon_state = "apc0";
	dir = 4
	},
/obj/structure/catwalk,
/obj/machinery/atmospherics/pipe/simple/hidden/supply{
	dir = 9;
	pixel_y = 0
	},
/obj/machinery/atmospherics/pipe/simple/hidden/scrubbers{
	dir = 9
	},
/turf/simulated/floor,
/area/shelltooth/level_five/hall)
"bn" = (
/obj/machinery/atmospherics/pipe/simple/hidden/supply,
/obj/machinery/atmospherics/pipe/simple/hidden/scrubbers{
	icon_state = "intact-scrubbers";
	dir = 1
	},
/turf/simulated/floor/tiled,
/area/shelltooth/level_five/heads)
"bo" = (
/obj/machinery/atmospherics/pipe/simple/hidden/supply{
	icon_state = "intact-supply";
	dir = 5
	},
/obj/machinery/atmospherics/pipe/simple/hidden/scrubbers{
	dir = 5
	},
/turf/simulated/floor/tiled,
/area/shelltooth/level_five/heads)
"bp" = (
/obj/machinery/light,
/obj/machinery/atmospherics/pipe/simple/hidden/supply{
	icon_state = "intact-supply";
	dir = 8
	},
/obj/machinery/atmospherics/pipe/simple/hidden/scrubbers{
	dir = 4
	},
/turf/simulated/floor/tiled,
/area/shelltooth/level_five/heads)
"bq" = (
/obj/machinery/atmospherics/pipe/simple/hidden/supply{
	icon_state = "intact-supply";
	dir = 8
	},
/obj/machinery/atmospherics/pipe/simple/hidden/scrubbers{
	dir = 4
	},
/turf/simulated/floor/tiled,
/area/shelltooth/level_five/heads)
"br" = (
/obj/machinery/atmospherics/pipe/simple/hidden/supply{
	icon_state = "intact-supply";
	dir = 8
	},
/obj/machinery/atmospherics/pipe/simple/hidden/scrubbers{
	dir = 10
	},
/turf/simulated/floor/tiled,
/area/shelltooth/level_five/heads)
"bs" = (
/obj/machinery/atmospherics/pipe/simple/hidden/supply,
/obj/machinery/atmospherics/pipe/manifold/hidden/scrubbers{
	icon_state = "map-scrubbers";
	dir = 4
	},
/turf/simulated/floor/tiled,
/area/shelltooth/level_five/matriarch)
"bt" = (
/obj/machinery/light{
	icon_state = "tube_map";
	dir = 4
	},
/obj/machinery/atmospherics/unary/vent_pump/on{
	icon_state = "map_vent_out";
	dir = 8;
	level = 2
	},
/turf/simulated/floor/tiled,
/area/shelltooth/level_five/hall)
"bu" = (
/obj/machinery/atmospherics/unary/vent_pump/on{
	icon_state = "map_vent_out";
	dir = 8;
	level = 2
	},
/turf/simulated/floor/tiled,
/area/shelltooth/level_five/heads)
"bv" = (
/obj/machinery/atmospherics/unary/vent_scrubber/on,
/turf/simulated/floor/tiled,
/area/shelltooth/level_five/attend)
"bw" = (
/obj/machinery/atmospherics/unary/vent_scrubber/on{
	icon_state = "map_scrubber_on";
	dir = 4
	},
/turf/simulated/floor/tiled,
/area/shelltooth/level_five/matriarch)
"bx" = (
/obj/machinery/atmospherics/unary/vent_scrubber/on{
	icon_state = "map_scrubber_on";
	dir = 1
	},
/turf/simulated/floor/tiled,
/area/shelltooth/level_five/hall)
"by" = (
/obj/machinery/atmospherics/unary/vent_scrubber/on{
	icon_state = "map_scrubber_on";
	dir = 1
	},
/turf/simulated/floor/tiled,
/area/shelltooth/level_five/heads)

(1,1,1) = {"
aa
aa
aa
aa
aa
aa
aa
aa
aa
aa
aa
aa
aa
aa
aa
aa
aa
aa
aa
aa
aa
aa
aa
aa
aa
aa
aa
aa
aa
aa
aa
aa
aa
aa
aa
aa
aa
aa
aa
aa
aa
aa
aa
aa
aa
aa
aa
aa
aa
aa
aa
aa
aa
aa
aa
aa
aa
aa
aa
aa
aa
aa
aa
aa
"}
(2,1,1) = {"
aa
aw
aa
aa
aa
aa
aa
aa
aa
aa
aa
aa
aa
aa
aa
aa
aa
aa
aa
aa
aa
aa
aa
aa
aa
aa
aa
aa
aa
aa
aa
aa
aa
aa
aa
aa
aa
aa
aa
aa
aa
aa
aa
aa
aa
aa
aa
aa
aa
aa
aa
aa
aa
aa
aa
aa
aa
aa
aa
aa
aa
aa
aa
aa
"}
(3,1,1) = {"
aa
aa
aa
aa
aa
aa
aa
aa
aa
aa
aa
aa
aa
aa
aa
aa
aa
aa
aa
aa
aa
aa
aa
aa
aa
aa
aa
aa
aa
aa
aa
aa
aa
aa
aa
aa
aa
aa
aa
aa
aa
aa
aa
aa
aa
aa
aa
aa
aa
aa
aa
aa
aa
aa
aa
aa
aa
aa
aa
aa
aa
aa
aa
aa
"}
(4,1,1) = {"
aa
aa
aa
aa
aa
aa
aa
aa
aa
aa
aa
aa
aa
aa
aa
aa
aa
aa
aa
aa
aa
aa
aa
aa
aa
aa
aa
aa
aa
aa
aa
aa
aa
aa
aa
aa
aa
aa
aa
aa
aa
aa
aa
aa
aa
aa
aa
aa
aa
aa
aa
aa
aa
aa
aa
aa
aa
aa
aa
aa
aa
aa
aa
aa
"}
(5,1,1) = {"
aa
aa
aa
aa
aa
aa
aa
aa
aa
aa
aa
aa
aa
aa
aa
aa
aa
aa
aa
aa
aa
aa
aa
aa
aa
aa
aa
aa
aa
aa
aa
aa
aa
aa
aa
aa
aa
aa
aa
aa
aa
aa
aa
aa
aa
aa
aa
aa
aa
aa
aa
aa
aa
aa
aa
aa
aa
aa
aa
aa
aa
aa
aa
aa
"}
(6,1,1) = {"
aa
aa
aa
aa
aa
aa
aa
aa
aa
aa
aa
aa
aa
aa
aa
aa
aa
aa
aa
aa
aa
aa
aa
aa
aa
aa
aa
aa
aa
aa
aa
aa
aa
aa
aa
aa
aa
aa
aa
aa
aa
aa
aa
aa
aa
aa
aa
aa
aa
aa
aa
aa
aa
aa
aa
aa
aa
aa
aa
aa
aa
aa
aa
aa
"}
(7,1,1) = {"
aa
aa
aa
aa
aa
aa
aa
aa
aa
aa
aa
aa
aa
aa
aa
aa
aa
aa
aa
aa
aa
aa
aa
aa
aa
aa
aa
aa
aa
aa
aa
aa
aa
aa
aa
aa
aa
aa
aa
aa
aa
aa
aa
aa
aa
aa
aa
aa
aa
aa
aa
aa
aa
aa
aa
aa
aa
aa
aa
aa
aa
aa
aa
aa
"}
(8,1,1) = {"
aa
aa
aa
aa
aa
aa
aa
aa
aa
aa
aa
aa
aa
aa
aa
aa
aa
aa
aa
aa
aa
aa
aa
aa
aa
aa
aa
aa
aa
aa
aa
aa
aa
aa
aa
aa
aa
aa
aa
aa
aa
aa
aa
aa
aa
aa
aa
aa
aa
aa
aa
aa
aa
aa
aa
aa
aa
aa
aa
aa
aa
aa
aa
aa
"}
(9,1,1) = {"
aa
aa
aa
aa
aa
aa
aa
aa
aa
aa
aa
aa
aa
aa
aa
aa
aa
aa
aa
aa
aa
aa
aa
aa
aa
aa
aa
aa
aa
aa
aa
aa
aa
aa
aa
aa
aa
aa
aa
aa
aa
aa
aa
aa
aa
aa
aa
aa
aa
aa
aa
aa
aa
aa
aa
aa
aa
aa
aa
aa
aa
aa
aa
aa
"}
(10,1,1) = {"
aa
aa
aa
aa
aa
aa
aa
aa
aa
aa
aa
aa
aa
aa
aa
aa
aa
aa
aa
aa
aa
aa
aa
aa
aa
aa
aa
aa
aa
aa
aa
aa
aa
aa
aa
aa
aa
aa
aa
aa
aa
aa
aa
aa
aa
aa
aa
aa
aa
aa
aa
aa
aa
aa
aa
aa
aa
aa
aa
aa
aa
aa
aa
aa
"}
(11,1,1) = {"
aa
aa
aa
aa
aa
aa
aa
aa
aa
aa
aa
aa
aa
aa
aa
aa
aa
aa
aa
aa
aa
aa
aa
aa
aa
aa
aa
aa
aa
aa
aa
aa
aa
aa
aa
aa
aa
aa
aa
aa
aa
aa
aa
aa
aa
aa
aa
aa
aa
aa
aa
aa
aa
aa
aa
aa
aa
aa
aa
aa
aa
aa
aa
aa
"}
(12,1,1) = {"
aa
aa
aa
aa
aa
aa
aa
aa
aa
aa
aa
aa
aa
aa
aa
aa
aa
aa
aa
aa
aa
aa
aa
aa
aa
aa
aa
aa
aa
aa
aa
aa
aa
aa
aa
aa
aa
aa
aa
aa
aa
aa
aa
aa
aa
aa
aa
aa
aa
aa
aa
aa
aa
aa
aa
aa
aa
aa
aa
aa
aa
aa
aa
aa
"}
(13,1,1) = {"
aa
aa
aa
aa
aa
aa
aa
aa
aa
aa
aa
aa
aa
aa
aa
aa
aa
aa
aa
aa
aa
aa
aa
aa
aa
aa
aa
aa
aa
aa
aa
aa
aa
aa
aa
aa
aa
aa
aa
aa
aa
aa
aa
aa
aa
aa
aa
aa
aa
aa
aa
aa
aa
aa
aa
aa
aa
aa
aa
aa
aa
aa
aa
aa
"}
(14,1,1) = {"
aa
aa
aa
aa
aa
aa
aa
aa
aa
aa
aa
aa
aa
aa
aa
aa
aa
aa
aa
aa
aa
aa
aa
aa
aa
aa
aa
aa
aa
aa
aa
aa
aa
aa
aa
aa
aa
aa
aa
aa
aa
aa
aa
aa
aa
aa
aa
aa
aa
aa
aa
aa
aa
aa
aa
aa
aa
aa
aa
aa
aa
aa
aa
aa
"}
(15,1,1) = {"
aa
aa
aa
aa
aa
aa
aa
aa
aa
aa
aa
aa
aa
aa
aa
aa
aa
aa
aa
aa
aa
aa
aa
aa
aa
aa
aa
aa
aa
aa
aa
aa
aa
aa
aa
aa
aa
aa
aa
aa
aa
aa
aa
aa
aa
aa
aa
aa
aa
aa
aa
aa
aa
aa
aa
aa
aa
aa
aa
aa
aa
aa
aa
aa
"}
(16,1,1) = {"
aa
aa
aa
aa
aa
aa
aa
aa
aa
aa
aa
aa
aa
aa
aa
aa
aa
aa
aa
aa
aa
aa
aa
aa
aa
aa
aa
aa
aa
aa
aa
aa
aa
aa
aa
aa
aa
aa
aa
aa
aa
aa
aa
aa
aa
aa
aa
aa
aa
aa
aa
aa
aa
aa
aa
aa
aa
aa
aa
aa
aa
aa
aa
aa
"}
(17,1,1) = {"
aa
aa
aa
aa
aa
aa
aa
aa
aa
aa
aa
aa
aa
aa
aa
aa
aa
aa
aa
aa
aa
aa
aa
aa
aa
aa
aa
aa
aa
aa
aa
aa
aa
aa
aa
aa
aa
aa
aa
aa
aa
aa
aa
aa
aa
aa
aa
aa
aa
aa
aa
aa
aa
aa
aa
aa
aa
aa
aa
aa
aa
aa
aa
aa
"}
(18,1,1) = {"
aa
aa
aa
aa
aa
aa
aa
aa
aa
aa
aa
aa
aa
aa
aa
aa
aa
aa
aa
aa
aa
aa
aa
aa
aa
aa
aa
aa
aa
aa
aa
aa
aa
aa
aa
aa
aa
aa
aa
aa
aa
aa
aa
aa
aa
aa
aa
aa
aa
aa
aa
aa
aa
aa
aa
aa
aa
aa
aa
aa
aa
aa
aa
aa
"}
(19,1,1) = {"
aa
aa
aa
aa
aa
aa
aa
aa
aa
aa
aa
aa
aa
aa
aa
aa
aa
aa
aa
aa
aa
aa
aa
aa
aa
aa
aa
aa
aa
aa
aa
aa
aa
aa
aa
aa
aa
aa
aa
aa
aa
aa
aa
aa
aa
aa
aa
aa
aa
aa
aa
aa
aa
aa
aa
aa
aa
aa
aa
aa
aa
aa
aa
aa
"}
(20,1,1) = {"
aa
aa
aa
aa
aa
aa
aa
aa
aa
aa
aa
aa
aa
aa
aa
aa
aa
aa
aa
aa
aa
aa
aa
aa
aa
aa
aa
aa
aa
aa
aa
aa
aa
aa
aa
aa
aa
aa
aa
aa
aa
aa
aa
aa
aa
aa
aa
aa
aa
aa
aa
aa
aa
aa
aa
aa
aa
aa
aa
aa
aa
aa
aa
aa
"}
(21,1,1) = {"
aa
aa
aa
aa
aa
aa
aa
aa
aa
aa
aa
aa
aa
aa
aa
aa
aa
aa
aa
aa
aa
aa
aa
aa
aa
aa
aa
aa
aa
aa
aa
aa
aa
aa
aa
aa
aa
aa
aa
aa
aa
aa
aa
aa
aa
aa
aa
aa
aa
aa
aa
aa
aa
aa
aa
aa
aa
aa
aa
aa
aa
aa
aa
aa
"}
(22,1,1) = {"
aa
aa
aa
aa
aa
aa
aa
aa
aa
aa
aa
aa
aa
aa
aa
aa
aa
aa
aa
aa
aa
aa
aa
aa
aa
aa
aa
aa
aa
aa
aa
aa
aa
aa
aa
aa
aa
aa
aa
aa
aa
aa
aa
aa
aa
aa
aa
aa
aa
aa
aa
aa
aa
aa
aa
aa
aa
aa
aa
aa
aa
aa
aa
aa
"}
(23,1,1) = {"
aa
aa
aa
aa
aa
aa
aa
aa
aa
aa
aa
aa
aa
aa
aa
aa
aa
aa
aa
aa
aa
aa
aa
aa
aa
aa
aa
aa
ab
ab
ab
ab
ab
ab
ab
ab
ab
aa
aa
aa
aa
aa
aa
aa
aa
aa
aa
aa
aa
aa
aa
aa
aa
aa
aa
aa
aa
aa
aa
aa
aa
aa
aa
aa
"}
(24,1,1) = {"
aa
aa
aa
aa
aa
aa
aa
aa
aa
aa
aa
aa
aa
aa
aa
aa
aa
aa
aa
aa
aa
aa
aa
aa
aa
aa
ab
ab
ab
ac
ac
ac
au
ac
ac
ac
ab
aK
aK
aK
aK
aa
aa
aa
aa
aa
aa
aa
aa
aa
aa
aa
aa
aa
aa
aa
aa
aa
aa
aa
aa
aa
aa
aa
"}
(25,1,1) = {"
aa
aa
aa
aa
aa
aa
aa
aa
aa
aa
aa
aa
aa
aa
aa
aa
aa
aa
aa
aa
aa
aa
ab
ab
ab
ab
ab
ac
ac
ac
ac
av
ac
bw
ac
ac
ab
aL
aL
aL
aK
aa
aa
aa
aa
aa
aa
aa
aa
aa
aa
aa
aa
aa
aa
aa
aa
aa
aa
aa
aa
aa
aa
aa
"}
(26,1,1) = {"
aa
aa
aa
aa
aa
aa
aa
aa
aa
aa
aa
aa
aa
aa
aa
aa
aa
aa
aa
aa
aO
aO
ab
ac
ac
ac
aE
bb
bb
bb
bb
aX
bb
bs
bb
bb
bi
bn
bn
bo
aK
aa
aa
aa
aa
aa
aa
aa
aa
aa
aa
aa
aa
aa
aa
aa
aa
aa
aa
aa
aa
aa
aa
aa
"}
(27,1,1) = {"
aa
aa
aa
aa
aa
aa
aa
aa
aa
aa
aa
aa
aa
aa
aa
aa
aa
aa
aa
aa
aO
aO
aP
ac
ac
ac
aH
ac
ac
ac
ac
ac
ac
ac
ac
ac
ah
aL
aL
bp
aK
aK
aK
aa
aa
aa
aa
aa
aa
aa
aa
aa
aa
aa
aa
aa
aa
aa
aa
aa
aa
aa
aa
aa
"}
(28,1,1) = {"
aa
aa
aa
aa
aa
aa
aa
aa
aa
aa
aa
aa
aa
aa
aa
aa
aa
aa
aa
aa
aO
aO
ab
ab
ab
ah
aI
ab
ab
ab
ab
ab
ab
ab
ab
ab
ab
aK
aL
bq
aL
aL
aK
aK
aa
aa
aa
aa
aa
aa
aa
aa
aa
aa
aa
aa
aa
aa
aa
aa
aa
aa
aa
aa
"}
(29,1,1) = {"
aa
aa
aa
aa
aa
aa
aa
aa
aa
aa
aa
aa
aa
aa
aa
aa
aa
aa
aa
aa
aO
aO
aO
aP
ae
ae
aU
ae
ad
am
aq
aq
aq
aq
aq
ay
aF
aK
aL
bq
aL
aL
aL
aK
aa
aa
aa
aa
aa
aa
aa
aa
aa
aa
aa
aa
aa
aa
aa
aa
aa
aa
aa
aa
"}
(30,1,1) = {"
aa
aa
aa
aa
aa
aa
aa
aa
aa
aa
aa
aa
aa
aa
aa
aa
aa
aa
aa
aa
aO
aO
aO
ad
ae
bv
aJ
ae
ad
an
ar
ar
ar
ar
ar
az
aG
aK
aL
br
by
aL
aL
aK
aa
aa
aa
aa
aa
aa
aa
aa
aa
aa
aa
aa
aa
aa
aa
aa
aa
aa
aa
aa
"}
(31,1,1) = {"
aa
aa
aa
aa
aa
aa
aa
aa
aa
aa
aa
aa
aa
aa
aa
aa
aa
aa
aa
aa
aa
aO
aO
ad
ae
ae
aU
ae
ad
an
ar
ar
ar
ar
ar
aA
aG
aK
aL
bk
aL
aL
aL
aK
aa
aa
aa
aa
aa
aa
aa
aa
aa
aa
aa
aa
aa
aa
aa
aa
aa
aa
aa
aa
"}
(32,1,1) = {"
aa
aa
aa
aa
aa
aa
aa
aa
aa
aa
aa
aa
aa
aa
aa
aa
aa
aa
aa
ax
aa
aO
aO
ad
af
ai
aW
al
ad
ao
ar
ar
ar
ar
ar
aB
bj
aK
aM
bu
aL
aL
aN
aK
aa
aa
aa
aa
aa
aa
aa
aa
aa
aa
aa
aa
aa
aa
aa
aa
aa
aa
aa
aa
"}
(33,1,1) = {"
aa
aa
aa
aa
aa
aa
aa
aa
aa
aa
aa
aa
aa
aa
aa
aa
aa
aa
aa
aa
aa
aO
aO
ad
ae
ae
aU
ae
ad
an
ar
ar
ar
ar
ar
aC
bl
aK
aL
aL
aL
aL
aL
aK
aa
aa
aa
aa
aa
aa
aa
aa
aa
aa
aa
aa
aa
aa
aa
aa
aa
aa
aa
aa
"}
(34,1,1) = {"
aa
aa
aa
aa
aa
aa
aa
aa
aa
aa
aa
aa
aa
aa
aa
aa
aa
aa
aa
aa
aa
aO
aO
ad
ae
ae
aU
ae
ad
an
ar
ar
ar
ar
ar
aD
bl
aK
aL
aL
aL
aL
aL
aK
aa
aa
aa
aa
aa
aa
aa
aa
aa
aa
aa
aa
aa
aa
aa
aa
aa
aa
aa
aa
"}
(35,1,1) = {"
aa
aa
aa
aa
aa
aa
aa
aa
aa
aa
aa
aa
aa
aa
aa
aa
aa
aa
aa
aa
aa
aO
aO
ad
ae
ae
aU
ae
ad
ap
as
at
be
bf
bg
bh
bm
aK
aL
aL
aL
aL
aL
aK
aa
aa
aa
aa
aa
aa
aa
aa
aa
aa
aa
aa
aa
aa
aa
aa
aa
aa
aa
aa
"}
(36,1,1) = {"
aa
aa
aa
aa
aa
aa
aa
aa
aa
aa
aa
aa
aa
aa
aa
aa
aa
aa
aa
aa
aa
aO
aO
ad
ad
aj
aY
ad
ad
ag
ag
ak
aZ
ak
ag
ag
ag
aK
aL
aL
aL
aL
aK
aK
aa
aa
aa
aa
aa
aa
aa
aa
aa
aa
aa
aa
aa
aa
aa
aa
aa
aa
aa
aa
"}
(37,1,1) = {"
aa
aa
aa
aa
aa
aa
aa
aa
aa
aa
aa
aa
aa
aa
aa
aa
aa
aa
aa
aa
aa
aO
aO
aO
aP
ak
aZ
ak
ak
ak
ak
ak
aZ
ak
ak
ak
ag
aL
aL
aN
aK
aK
aK
aa
aa
aa
aa
aa
aa
aa
aa
aa
aa
aa
aa
aa
aa
aa
aa
aa
aa
aa
aa
aa
"}
(38,1,1) = {"
aa
aa
aa
aa
aa
aa
aa
aa
aa
aa
aa
aa
aa
aa
aa
aa
aa
aa
aa
aa
aa
aO
aO
aO
ag
ak
ba
bc
bc
bc
bc
bc
bd
bx
ak
ak
ag
aL
aL
aL
aK
aa
aa
aa
aa
aa
aa
aa
aa
aa
aa
aa
aa
aa
aa
aa
aa
aa
aa
aa
aa
aa
aa
aa
"}
(39,1,1) = {"
aa
aa
aa
aa
aa
aa
aa
aa
aa
aa
aa
aa
aa
aa
aa
aa
aa
aa
aa
aa
aa
aa
aa
aa
ag
ag
ag
ak
ak
ak
ak
ak
aV
ak
ak
ak
ag
aL
aL
aL
aK
aa
aa
aa
aa
aa
aa
aa
aa
aa
aa
aa
aa
aa
aa
aa
aa
aa
aa
aa
aa
aa
aa
aa
"}
(40,1,1) = {"
aa
aa
aa
aa
aa
aa
aa
aa
aa
aa
aa
aa
aa
aa
aa
aa
aa
aa
aa
aa
aa
aa
aa
aa
aa
aa
ag
ag
ag
ak
ak
ak
bt
ak
ak
ak
ag
aK
aK
aT
aK
aS
aa
aa
aa
aa
aa
aa
aa
aa
aa
aa
aa
aa
aa
aa
aa
aa
aa
aa
aa
aa
aa
aa
"}
(41,1,1) = {"
aa
aa
aa
aa
aa
aa
aa
aa
aa
aa
aa
aa
aa
aa
aa
aa
aa
aa
aa
aa
aa
aa
aa
aa
aa
aa
aa
aa
ag
ag
ag
ag
ag
ag
ag
aT
ag
aS
aS
aS
aS
aS
aa
aa
aa
aa
aa
aa
aa
aa
aa
aa
aa
aa
aa
aa
aa
aa
aa
aa
aa
aa
aa
aa
"}
(42,1,1) = {"
aa
aa
aa
aa
aa
aa
aa
aa
aa
aa
aa
aa
aa
aa
aa
aa
aa
aa
aa
aa
aa
aa
aa
aa
aa
aa
aa
aa
aa
aa
aa
aR
aa
aa
aS
aS
aS
aS
aS
aS
aS
aS
aa
aa
aa
aa
aa
aa
aa
aa
aa
aa
aa
aa
aa
aa
aa
aa
aa
aa
aa
aa
aa
aa
"}
(43,1,1) = {"
aa
aa
aa
aa
aa
aa
aa
aa
aa
aa
aa
aa
aa
aa
aa
aa
aa
aa
aa
aa
aa
aa
aa
aa
aa
aa
aa
aa
aa
aa
aa
aR
aa
aa
aS
aS
aS
aS
aS
aa
aa
aa
aa
aa
aa
aa
aa
aa
aa
aa
aa
aa
aa
aa
aa
aa
aa
aa
aa
aa
aa
aa
aa
aa
"}
(44,1,1) = {"
aa
aa
aa
aa
aa
aa
aa
aa
aa
aa
aa
aa
aa
aa
aa
aa
aa
aa
aa
aa
aa
aa
aa
aa
aa
aa
aa
aa
aa
aa
aa
aR
aa
aa
aa
aa
aa
aa
aa
aa
aa
aa
aa
aa
aa
aa
aa
aa
aa
aa
aa
aa
aa
aa
aa
aa
aa
aa
aa
aa
aa
aa
aa
aa
"}
(45,1,1) = {"
aa
aa
aa
aa
aa
aa
aa
aa
aa
aa
aa
aa
aa
aa
aa
aa
aa
aa
aa
aa
aa
aa
aa
aa
aa
aa
aa
aa
aa
aQ
aQ
aQ
aQ
aQ
aa
aa
aa
aa
aa
aa
aa
aa
aa
aa
aa
aa
aa
aa
aa
aa
aa
aa
aa
aa
aa
aa
aa
aa
aa
aa
aa
aa
aa
aa
"}
(46,1,1) = {"
aa
aa
aa
aa
aa
aa
aa
aa
aa
aa
aa
aa
aa
aa
aa
aa
aa
aa
aa
aa
aa
aa
aa
aa
aa
aa
aa
aa
aa
aQ
aQ
aQ
aQ
aQ
aa
aa
aa
aa
aa
aa
aa
aa
aa
aa
aa
aa
aa
aa
aa
aa
aa
aa
aa
aa
aa
aa
aa
aa
aa
aa
aa
aa
aa
aa
"}
(47,1,1) = {"
aa
aa
aa
aa
aa
aa
aa
aa
aa
aa
aa
aa
aa
aa
aa
aa
aa
aa
aa
aa
aa
aa
aa
aa
aa
aa
aa
aa
aa
aQ
aQ
aQ
aQ
aQ
aa
aa
aa
aa
aa
aa
aa
aa
aa
aa
aa
aa
aa
aa
aa
aa
aa
aa
aa
aa
aa
aa
aa
aa
aa
aa
aa
aa
aa
aa
"}
(48,1,1) = {"
aa
aa
aa
aa
aa
aa
aa
aa
aa
aa
aa
aa
aa
aa
aa
aa
aa
aa
aa
aa
aa
aa
aa
aa
aa
aa
aa
aa
aa
aQ
aQ
aQ
aQ
aQ
aa
aa
aa
aa
aa
aa
aa
aa
aa
aa
aa
aa
aa
aa
aa
aa
aa
aa
aa
aa
aa
aa
aa
aa
aa
aa
aa
aa
aa
aa
"}
(49,1,1) = {"
aa
aa
aa
aa
aa
aa
aa
aa
aa
aa
aa
aa
aa
aa
aa
aa
aa
aa
aa
aa
aa
aa
aa
aa
aa
aa
aa
aa
aa
aQ
aQ
aQ
aQ
aQ
aa
aa
aa
aa
aa
aa
aa
aa
aa
aa
aa
aa
aa
aa
aa
aa
aa
aa
aa
aa
aa
aa
aa
aa
aa
aa
aa
aa
aa
aa
"}
(50,1,1) = {"
aa
aa
aa
aa
aa
aa
aa
aa
aa
aa
aa
aa
aa
aa
aa
aa
aa
aa
aa
aa
aa
aa
aa
aa
aa
aa
aa
aa
aa
aa
aa
aa
aa
aa
aa
aa
aa
aa
aa
aa
aa
aa
aa
aa
aa
aa
aa
aa
aa
aa
aa
aa
aa
aa
aa
aa
aa
aa
aa
aa
aa
aa
aa
aa
"}
(51,1,1) = {"
aa
aa
aa
aa
aa
aa
aa
aa
aa
aa
aa
aa
aa
aa
aa
aa
aa
aa
aa
aa
aa
aa
aa
aa
aa
aa
aa
aa
aa
aa
aa
aa
aa
aa
aa
aa
aa
aa
aa
aa
aa
aa
aa
aa
aa
aa
aa
aa
aa
aa
aa
aa
aa
aa
aa
aa
aa
aa
aa
aa
aa
aa
aa
aa
"}
(52,1,1) = {"
aa
aa
aa
aa
aa
aa
aa
aa
aa
aa
aa
aa
aa
aa
aa
aa
aa
aa
aa
aa
aa
aa
aa
aa
aa
aa
aa
aa
aa
aa
aa
aa
aa
aa
aa
aa
aa
aa
aa
aa
aa
aa
aa
aa
aa
aa
aa
aa
aa
aa
aa
aa
aa
aa
aa
aa
aa
aa
aa
aa
aa
aa
aa
aa
"}
(53,1,1) = {"
aa
aa
aa
aa
aa
aa
aa
aa
aa
aa
aa
aa
aa
aa
aa
aa
aa
aa
aa
aa
aa
aa
aa
aa
aa
aa
aa
aa
aa
aa
aa
aa
aa
aa
aa
aa
aa
aa
aa
aa
aa
aa
aa
aa
aa
aa
aa
aa
aa
aa
aa
aa
aa
aa
aa
aa
aa
aa
aa
aa
aa
aa
aa
aa
"}
(54,1,1) = {"
aa
aa
aa
aa
aa
aa
aa
aa
aa
aa
aa
aa
aa
aa
aa
aa
aa
aa
aa
aa
aa
aa
aa
aa
aa
aa
aa
aa
aa
aa
aa
aa
aa
aa
aa
aa
aa
aa
aa
aa
aa
aa
aa
aa
aa
aa
aa
aa
aa
aa
aa
aa
aa
aa
aa
aa
aa
aa
aa
aa
aa
aa
aa
aa
"}
(55,1,1) = {"
aa
aa
aa
aa
aa
aa
aa
aa
aa
aa
aa
aa
aa
aa
aa
aa
aa
aa
aa
aa
aa
aa
aa
aa
aa
aa
aa
aa
aa
aa
aa
aa
aa
aa
aa
aa
aa
aa
aa
aa
aa
aa
aa
aa
aa
aa
aa
aa
aa
aa
aa
aa
aa
aa
aa
aa
aa
aa
aa
aa
aa
aa
aa
aa
"}
(56,1,1) = {"
aa
aa
aa
aa
aa
aa
aa
aa
aa
aa
aa
aa
aa
aa
aa
aa
aa
aa
aa
aa
aa
aa
aa
aa
aa
aa
aa
aa
aa
aa
aa
aa
aa
aa
aa
aa
aa
aa
aa
aa
aa
aa
aa
aa
aa
aa
aa
aa
aa
aa
aa
aa
aa
aa
aa
aa
aa
aa
aa
aa
aa
aa
aa
aa
"}
(57,1,1) = {"
aa
aa
aa
aa
aa
aa
aa
aa
aa
aa
aa
aa
aa
aa
aa
aa
aa
aa
aa
aa
aa
aa
aa
aa
aa
aa
aa
aa
aa
aa
aa
aa
aa
aa
aa
aa
aa
aa
aa
aa
aa
aa
aa
aa
aa
aa
aa
aa
aa
aa
aa
aa
aa
aa
aa
aa
aa
aa
aa
aa
aa
aa
aa
aa
"}
(58,1,1) = {"
aa
aa
aa
aa
aa
aa
aa
aa
aa
aa
aa
aa
aa
aa
aa
aa
aa
aa
aa
aa
aa
aa
aa
aa
aa
aa
aa
aa
aa
aa
aa
aa
aa
aa
aa
aa
aa
aa
aa
aa
aa
aa
aa
aa
aa
aa
aa
aa
aa
aa
aa
aa
aa
aa
aa
aa
aa
aa
aa
aa
aa
aa
aa
aa
"}
(59,1,1) = {"
aa
aa
aa
aa
aa
aa
aa
aa
aa
aa
aa
aa
aa
aa
aa
aa
aa
aa
aa
aa
aa
aa
aa
aa
aa
aa
aa
aa
aa
aa
aa
aa
aa
aa
aa
aa
aa
aa
aa
aa
aa
aa
aa
aa
aa
aa
aa
aa
aa
aa
aa
aa
aa
aa
aa
aa
aa
aa
aa
aa
aa
aa
aa
aa
"}
(60,1,1) = {"
aa
aa
aa
aa
aa
aa
aa
aa
aa
aa
aa
aa
aa
aa
aa
aa
aa
aa
aa
aa
aa
aa
aa
aa
aa
aa
aa
aa
aa
aa
aa
aa
aa
aa
aa
aa
aa
aa
aa
aa
aa
aa
aa
aa
aa
aa
aa
aa
aa
aa
aa
aa
aa
aa
aa
aa
aa
aa
aa
aa
aa
aa
aa
aa
"}
(61,1,1) = {"
aa
aa
aa
aa
aa
aa
aa
aa
aa
aa
aa
aa
aa
aa
aa
aa
aa
aa
aa
aa
aa
aa
aa
aa
aa
aa
aa
aa
aa
aa
aa
aa
aa
aa
aa
aa
aa
aa
aa
aa
aa
aa
aa
aa
aa
aa
aa
aa
aa
aa
aa
aa
aa
aa
aa
aa
aa
aa
aa
aa
aa
aa
aa
aa
"}
(62,1,1) = {"
aa
aa
aa
aa
aa
aa
aa
aa
aa
aa
aa
aa
aa
aa
aa
aa
aa
aa
aa
aa
aa
aa
aa
aa
aa
aa
aa
aa
aa
aa
aa
aa
aa
aa
aa
aa
aa
aa
aa
aa
aa
aa
aa
aa
aa
aa
aa
aa
aa
aa
aa
aa
aa
aa
aa
aa
aa
aa
aa
aa
aa
aa
aa
aa
"}
(63,1,1) = {"
aa
aa
aa
aa
aa
aa
aa
aa
aa
aa
aa
aa
aa
aa
aa
aa
aa
aa
aa
aa
aa
aa
aa
aa
aa
aa
aa
aa
aa
aa
aa
aa
aa
aa
aa
aa
aa
aa
aa
aa
aa
aa
aa
aa
aa
aa
aa
aa
aa
aa
aa
aa
aa
aa
aa
aa
aa
aa
aa
aa
aa
aa
aa
aa
"}
(64,1,1) = {"
aa
aa
aa
aa
aa
aa
aa
aa
aa
aa
aa
aa
aa
aa
aa
aa
aa
aa
aa
aa
aa
aa
aa
aa
aa
aa
aa
aa
aa
aa
aa
aa
aa
aa
aa
aa
aa
aa
aa
aa
aa
aa
aa
aa
aa
aa
aa
aa
aa
aa
aa
aa
aa
aa
aa
aa
aa
aa
aa
aa
aa
aa
aa
aa
"}
