//MAP CONVERTED BY dmm2tgm.py THIS HEADER COMMENT PREVENTS RECONVERSION, DO NOT REMOVE
"a" = (
/turf/unsimulated/dark_filler,
/area/space)
"l" = (
/turf/exterior/mud,
/area/shelltooth/wetland)
"m" = (
/obj/abstract/level_data_spawner/shelltooth/wetland,
/turf/exterior/sand,
/area/shelltooth/wetland)
"p" = (
/obj/structure/cable{
	icon_state = "4-8"
	},
/turf/exterior/sand,
/area/shelltooth/wetland)
"q" = (
/turf/exterior/wall,
/area/shelltooth/wetland)
"D" = (
/turf/exterior/dry,
/area/shelltooth/wetland)
"E" = (
/turf/unsimulated/mask,
/area/shelltooth/wetland)
"H" = (
/turf/exterior/sand,
/area/shelltooth/wetland)
"I" = (
/obj/structure/cable{
	icon_state = "0-8"
	},
/turf/exterior/dry,
/area/shelltooth/wetland)
"Y" = (
/turf/exterior/water,
/area/shelltooth/wetland)

(1,1,1) = {"
a
a
a
a
a
a
a
a
a
a
a
a
a
a
a
a
a
a
a
a
a
a
a
a
a
a
a
a
a
a
a
a
a
a
a
a
a
a
a
a
a
a
a
a
a
a
a
a
a
a
a
a
a
a
a
a
a
a
a
a
a
a
a
a
a
a
a
a
a
a
a
a
a
a
a
a
a
a
a
a
a
a
a
a
a
a
a
a
a
a
a
a
a
a
a
a
a
a
a
a
a
a
a
a
a
a
a
a
a
a
a
a
a
a
"}
(2,1,1) = {"
a
a
a
a
a
a
a
a
a
a
a
a
a
a
a
a
a
a
a
a
a
a
a
a
a
a
a
a
a
a
a
a
a
a
a
a
a
a
a
a
a
a
a
a
a
a
a
a
a
a
a
a
a
a
a
a
a
a
a
a
a
a
a
a
a
a
a
a
a
a
a
a
a
a
a
a
a
a
a
a
a
a
a
a
a
a
a
a
a
a
a
a
a
a
a
a
a
a
a
a
a
a
a
a
a
a
a
a
a
a
a
a
a
a
"}
(3,1,1) = {"
a
a
a
a
a
a
a
a
a
a
a
a
a
a
a
a
a
a
a
a
a
a
a
a
a
a
a
a
a
a
a
a
a
a
a
a
a
a
a
a
a
a
a
a
a
a
a
a
a
a
a
a
a
a
a
a
a
a
a
a
a
a
a
a
a
a
a
a
a
a
a
a
a
a
a
a
a
a
a
a
a
a
a
a
a
a
a
a
a
a
a
a
a
a
a
a
a
a
a
a
a
a
a
a
a
a
a
a
a
a
a
a
a
a
"}
(4,1,1) = {"
a
a
a
a
a
a
a
a
a
a
a
a
a
a
a
a
a
a
a
a
a
a
a
a
a
a
a
a
a
a
a
a
a
a
a
a
a
a
a
a
a
a
a
a
a
a
a
a
a
a
a
a
a
a
a
a
a
a
a
a
a
a
a
a
a
a
a
a
a
a
a
a
a
a
a
a
a
a
a
a
a
a
a
a
a
a
a
a
a
a
a
a
a
a
a
a
a
a
a
a
a
a
a
a
a
a
a
a
a
a
a
a
a
a
"}
(5,1,1) = {"
a
a
a
a
a
a
a
a
a
a
a
a
a
a
a
a
a
a
a
a
a
a
a
a
a
a
a
a
a
a
a
a
a
a
a
a
a
a
a
a
a
a
a
a
a
a
a
a
a
a
a
a
a
a
a
a
a
a
a
a
a
a
a
a
a
a
a
a
a
a
a
a
a
a
a
a
a
a
a
a
a
a
a
a
a
a
a
a
a
a
a
a
a
a
a
a
a
a
a
a
a
a
a
a
a
a
a
a
a
a
a
a
a
a
"}
(6,1,1) = {"
a
a
a
a
a
a
a
a
a
a
a
a
a
a
a
a
a
a
a
a
a
a
a
a
a
a
a
a
a
a
a
a
a
a
a
a
a
a
a
a
a
a
a
a
a
a
a
a
a
a
a
a
a
a
a
a
a
a
a
a
a
a
a
a
a
a
a
a
a
a
a
a
a
a
a
a
a
a
a
a
a
a
a
a
a
a
a
a
a
a
a
a
a
a
a
a
a
a
a
a
a
a
a
a
a
a
a
a
a
a
a
a
a
a
"}
(7,1,1) = {"
a
a
a
a
a
a
a
a
a
a
a
a
a
a
a
a
a
a
a
a
a
a
a
a
a
a
a
a
a
a
a
a
a
a
a
a
a
a
a
a
a
a
a
a
a
a
a
a
a
a
a
a
a
a
a
a
a
a
a
a
a
a
a
a
a
a
a
a
a
a
a
a
a
a
a
a
a
a
a
a
a
a
a
a
a
a
a
a
a
a
a
a
a
a
a
a
a
a
a
a
a
a
a
a
a
a
a
a
a
a
a
a
a
a
"}
(8,1,1) = {"
a
a
a
a
a
a
a
q
q
q
q
q
q
q
q
q
q
q
q
q
q
q
q
q
q
q
q
q
q
q
q
q
q
q
q
D
l
l
Y
Y
Y
Y
Y
Y
l
l
D
D
H
H
p
H
H
H
H
H
H
H
H
H
H
H
H
H
H
H
H
H
H
H
H
H
H
H
H
H
H
H
H
H
H
H
H
H
H
H
H
H
H
H
H
H
H
H
H
H
H
H
H
H
H
H
H
H
H
m
H
a
a
a
a
a
a
a
"}
(9,1,1) = {"
a
a
a
a
a
a
a
q
q
q
q
q
q
q
q
q
q
q
q
q
q
q
q
q
q
q
q
q
q
q
q
q
q
q
D
D
l
Y
Y
Y
Y
Y
Y
l
l
D
D
H
H
H
p
H
H
H
H
H
H
H
H
H
H
H
H
H
H
H
H
H
H
H
H
H
H
D
D
D
D
D
D
H
H
H
H
H
H
H
H
H
H
H
D
D
D
D
H
H
H
H
H
H
H
H
H
H
H
H
H
a
a
a
a
a
a
a
"}
(10,1,1) = {"
a
a
a
a
a
a
a
q
q
q
q
q
q
q
q
q
q
q
q
q
q
q
q
q
q
q
q
q
q
q
q
q
H
H
D
l
l
Y
Y
Y
Y
Y
l
l
D
D
H
H
H
H
p
H
H
H
H
D
D
D
D
D
H
H
H
H
H
H
H
H
D
D
D
D
D
D
D
D
D
D
D
D
D
D
D
D
D
D
D
D
D
D
D
D
D
D
D
D
D
D
D
D
H
H
H
H
H
H
H
a
a
a
a
a
a
a
"}
(11,1,1) = {"
a
a
a
a
a
a
a
q
q
q
q
q
q
q
q
q
q
q
q
q
q
q
q
q
q
q
q
q
q
q
q
H
D
D
D
l
Y
Y
Y
Y
Y
l
l
D
D
H
H
H
H
H
p
H
D
D
D
D
D
D
D
D
D
D
D
D
D
D
D
D
D
D
D
D
D
D
D
E
E
E
E
E
E
E
E
E
E
E
E
E
E
E
E
E
E
E
E
D
D
D
D
D
D
H
H
H
H
H
H
a
a
a
a
a
a
a
"}
(12,1,1) = {"
a
a
a
a
a
a
a
q
q
q
q
q
q
q
q
q
q
q
q
q
q
q
q
q
q
q
q
q
q
q
H
H
D
l
l
l
Y
Y
Y
Y
Y
l
D
D
H
H
H
D
D
D
I
D
D
D
D
D
D
D
D
D
D
D
D
D
D
D
E
E
E
E
E
E
E
E
E
E
E
E
E
E
E
E
E
E
E
E
E
E
E
E
E
E
E
E
E
E
E
E
E
D
D
D
D
D
H
H
H
a
a
a
a
a
a
a
"}
(13,1,1) = {"
a
a
a
a
a
a
a
q
q
q
q
q
q
q
q
q
q
q
q
q
q
q
q
q
q
q
q
q
q
H
H
D
D
l
Y
Y
Y
Y
Y
Y
l
l
D
D
H
H
D
D
D
D
D
E
E
E
E
E
E
D
D
D
D
D
E
E
E
E
E
E
E
E
E
E
E
E
E
E
E
E
E
E
E
E
E
E
E
E
E
E
E
E
E
E
E
E
E
E
E
E
E
E
E
D
D
D
D
H
H
a
a
a
a
a
a
a
"}
(14,1,1) = {"
a
a
a
a
a
a
a
q
q
q
q
q
q
q
q
q
q
q
q
q
q
q
q
q
q
q
q
q
H
H
H
D
l
l
Y
Y
Y
Y
Y
l
l
D
D
H
H
D
D
D
E
E
E
E
E
E
E
E
E
E
E
E
E
E
E
E
E
E
E
E
E
E
E
E
E
E
E
E
E
E
E
E
E
E
E
E
E
E
E
E
E
E
E
E
E
E
E
E
E
E
E
E
E
E
E
D
D
H
H
a
a
a
a
a
a
a
"}
(15,1,1) = {"
a
a
a
a
a
a
a
q
q
q
q
q
q
q
q
q
q
q
q
q
q
q
q
q
q
q
q
q
H
H
H
D
l
Y
Y
Y
Y
Y
Y
l
D
D
D
H
D
D
D
E
E
E
E
E
E
E
E
E
E
E
E
E
E
E
E
E
E
E
E
E
E
E
E
E
E
E
E
E
E
E
E
E
E
E
E
E
E
E
E
E
E
E
E
E
E
E
E
E
E
E
E
E
E
E
E
D
D
D
H
a
a
a
a
a
a
a
"}
(16,1,1) = {"
a
a
a
a
a
a
a
q
q
q
q
q
q
q
q
q
q
q
q
q
q
q
q
q
q
q
q
q
H
H
H
D
l
Y
Y
Y
Y
Y
Y
l
D
D
D
D
D
D
E
E
E
E
E
E
E
E
E
E
E
E
E
E
E
E
E
E
E
E
E
E
E
E
E
E
E
E
E
E
E
E
E
E
E
E
E
E
E
E
E
E
E
E
E
E
E
E
E
E
E
E
E
E
E
E
E
E
D
D
H
a
a
a
a
a
a
a
"}
(17,1,1) = {"
a
a
a
a
a
a
a
q
q
q
q
q
q
q
q
q
q
q
q
q
q
q
q
q
q
q
q
H
H
H
H
D
l
Y
Y
Y
Y
Y
Y
l
D
D
D
D
D
E
E
E
E
E
E
E
E
E
E
E
E
E
E
E
E
E
E
E
E
E
E
E
E
E
E
E
E
E
E
E
E
E
E
E
E
E
E
E
E
E
E
E
E
E
E
E
E
E
E
E
E
E
E
E
E
E
E
E
D
D
H
a
a
a
a
a
a
a
"}
(18,1,1) = {"
a
a
a
a
a
a
a
q
q
q
q
q
q
q
q
q
q
q
q
q
q
q
q
q
q
q
q
H
H
H
D
D
l
Y
Y
Y
Y
Y
l
l
D
D
D
D
E
E
E
E
E
E
E
E
E
E
E
E
E
E
E
E
E
E
E
E
E
E
E
E
E
E
E
E
E
E
E
E
E
E
E
E
E
E
E
E
E
E
E
E
E
E
E
E
E
E
E
E
E
E
E
E
E
E
E
E
D
D
H
a
a
a
a
a
a
a
"}
(19,1,1) = {"
a
a
a
a
a
a
a
q
q
q
q
q
q
q
q
q
q
q
q
q
q
q
q
q
q
q
H
H
H
H
D
D
l
Y
Y
Y
Y
Y
l
D
D
D
D
D
E
E
E
E
E
E
E
E
E
E
E
E
E
E
E
E
E
E
E
E
E
E
E
E
E
E
E
E
E
E
E
E
E
E
E
E
E
E
E
E
E
E
E
E
E
E
E
E
E
E
E
E
E
E
E
E
E
E
E
E
D
D
H
a
a
a
a
a
a
a
"}
(20,1,1) = {"
a
a
a
a
a
a
a
q
q
q
q
q
q
q
q
q
q
q
q
q
q
q
q
q
q
q
H
H
H
D
D
l
l
Y
Y
Y
Y
l
l
D
D
D
D
E
E
E
E
E
E
E
E
E
E
E
E
E
E
E
E
E
E
E
E
E
E
E
E
E
E
E
E
E
E
E
E
E
E
E
E
E
E
E
E
E
E
E
E
E
E
E
E
E
E
E
E
E
E
E
E
E
E
E
E
E
D
D
H
a
a
a
a
a
a
a
"}
(21,1,1) = {"
a
a
a
a
a
a
a
q
q
q
q
q
q
q
q
q
q
q
q
q
q
q
q
q
q
H
H
H
H
D
l
l
Y
Y
Y
Y
Y
l
D
D
D
D
D
E
E
E
E
E
E
E
E
E
E
E
E
E
E
E
E
E
E
E
E
E
E
E
E
E
E
E
E
E
E
E
E
E
E
E
E
E
E
E
E
E
E
E
E
E
E
E
E
E
E
E
E
E
E
E
E
E
E
E
E
E
D
D
H
a
a
a
a
a
a
a
"}
(22,1,1) = {"
a
a
a
a
a
a
a
q
q
q
q
q
q
q
q
q
q
q
q
q
q
q
q
q
H
H
H
H
H
D
l
l
Y
Y
Y
Y
Y
l
D
D
D
D
D
E
E
E
E
E
E
E
E
E
E
E
E
E
E
E
E
E
E
E
E
E
E
E
E
E
E
E
E
E
E
E
E
E
E
E
E
E
E
E
E
E
E
E
E
E
E
E
E
E
E
E
E
E
E
E
E
E
E
E
E
E
D
D
D
a
a
a
a
a
a
a
"}
(23,1,1) = {"
a
a
a
a
a
a
a
q
q
q
q
q
q
q
q
q
q
q
q
q
q
q
q
H
H
H
H
D
D
l
l
Y
Y
Y
Y
Y
l
l
D
D
D
D
D
E
E
E
E
E
E
E
E
E
E
E
E
E
E
E
E
E
E
E
E
E
E
E
E
E
E
E
E
E
E
E
E
E
E
E
E
E
E
E
E
E
E
E
E
E
E
E
E
E
E
E
E
E
E
E
E
E
E
E
E
E
D
D
D
a
a
a
a
a
a
a
"}
(24,1,1) = {"
a
a
a
a
a
a
a
q
q
q
q
q
q
q
q
q
q
q
q
q
q
H
H
H
H
H
D
D
l
l
Y
Y
Y
Y
Y
l
l
D
D
D
D
D
D
E
E
E
E
E
E
E
E
E
E
E
E
E
E
E
E
E
E
E
E
E
E
E
E
E
E
E
E
E
E
E
E
E
E
E
E
E
E
E
E
E
E
E
E
E
E
E
E
E
E
E
E
E
E
E
E
E
E
E
E
E
D
D
D
a
a
a
a
a
a
a
"}
(25,1,1) = {"
a
a
a
a
a
a
a
q
q
q
q
q
q
q
q
q
q
q
q
H
H
H
H
H
H
H
D
l
l
Y
Y
Y
Y
Y
Y
l
D
D
D
D
D
D
E
E
E
E
E
E
E
E
E
E
E
E
E
E
E
E
E
E
E
E
E
E
E
E
E
E
E
E
E
E
E
E
E
E
E
E
E
E
E
E
E
E
E
E
E
E
E
E
E
E
E
E
E
E
E
E
E
E
E
E
E
E
D
D
D
a
a
a
a
a
a
a
"}
(26,1,1) = {"
a
a
a
a
a
a
a
q
q
q
q
q
q
q
q
q
q
H
H
H
H
H
H
H
H
D
l
l
Y
Y
Y
Y
Y
Y
l
l
D
D
D
D
D
D
E
E
E
E
E
E
E
E
E
E
E
E
E
E
E
E
E
E
E
E
E
E
E
E
E
E
E
E
E
E
E
E
E
E
E
E
E
E
E
E
E
E
E
E
E
E
E
E
E
E
E
E
E
E
E
E
E
E
E
E
E
E
D
D
D
a
a
a
a
a
a
a
"}
(27,1,1) = {"
a
a
a
a
a
a
a
q
q
q
q
q
q
q
q
q
H
H
H
H
H
H
H
H
D
l
l
Y
Y
Y
Y
Y
Y
l
l
D
D
D
D
D
D
E
E
E
E
E
E
E
E
E
E
E
E
E
E
E
E
E
E
E
E
E
E
E
E
E
E
E
E
E
E
E
E
E
E
E
E
E
E
E
E
E
E
E
E
E
E
E
E
E
E
E
E
E
E
E
E
E
E
E
E
E
E
E
D
D
D
a
a
a
a
a
a
a
"}
(28,1,1) = {"
a
a
a
a
a
a
a
q
q
q
q
q
q
q
q
H
H
H
H
H
H
H
H
D
l
l
Y
Y
Y
Y
Y
Y
l
l
D
D
D
D
D
D
E
E
E
E
E
E
E
E
E
E
E
E
E
E
E
E
E
E
E
E
E
E
E
E
E
E
E
E
E
E
E
E
E
E
E
E
E
E
E
E
E
E
E
E
E
E
E
E
E
E
E
E
E
E
E
E
E
E
E
E
E
E
E
E
D
D
D
a
a
a
a
a
a
a
"}
(29,1,1) = {"
a
a
a
a
a
a
a
q
q
q
q
q
q
q
q
H
H
H
H
H
H
H
D
l
l
Y
Y
Y
Y
Y
Y
Y
l
D
D
D
D
D
D
E
E
E
E
E
E
E
E
E
E
E
E
E
E
E
E
E
E
E
E
E
E
E
E
E
E
E
E
E
E
E
E
E
E
E
E
E
E
E
E
E
E
E
E
E
E
E
E
E
E
E
E
E
E
E
E
E
E
E
E
E
E
E
E
E
D
D
D
a
a
a
a
a
a
a
"}
(30,1,1) = {"
a
a
a
a
a
a
a
q
q
q
q
q
q
q
H
H
H
H
H
H
H
D
D
l
Y
Y
Y
Y
Y
Y
Y
l
D
D
D
D
D
D
D
E
E
E
E
E
E
E
E
E
E
E
E
E
E
E
E
E
E
E
E
E
E
E
E
E
E
E
E
E
E
E
E
E
E
E
E
E
E
E
E
E
E
E
E
E
E
E
E
E
E
E
E
E
E
E
E
E
E
E
E
E
E
E
E
E
D
D
D
a
a
a
a
a
a
a
"}
(31,1,1) = {"
a
a
a
a
a
a
a
q
q
q
q
q
q
q
H
H
H
H
H
H
H
D
l
l
Y
Y
Y
Y
Y
Y
Y
l
D
D
D
D
D
D
E
E
E
E
E
E
E
E
E
E
E
E
E
E
E
E
E
E
E
E
E
E
E
E
E
E
E
E
E
E
E
E
E
E
E
E
E
E
E
E
E
E
E
E
E
E
E
E
E
E
E
E
E
E
E
E
E
E
E
E
E
E
E
E
E
E
D
D
D
a
a
a
a
a
a
a
"}
(32,1,1) = {"
a
a
a
a
a
a
a
q
q
q
q
q
q
H
H
H
H
H
H
H
D
l
l
Y
Y
Y
Y
Y
Y
Y
l
l
D
D
D
D
D
E
E
E
E
E
E
E
E
E
E
E
E
E
E
E
E
E
E
E
E
E
E
E
E
E
E
E
E
E
E
E
E
E
E
E
E
E
E
E
E
E
E
E
E
E
E
E
E
E
E
E
E
E
E
E
E
E
E
E
E
E
E
E
E
E
E
E
D
D
D
a
a
a
a
a
a
a
"}
(33,1,1) = {"
a
a
a
a
a
a
a
q
q
q
q
q
q
H
H
H
H
H
H
H
D
l
l
Y
Y
Y
Y
Y
Y
Y
l
D
D
D
D
D
E
E
E
E
E
E
E
E
E
E
E
E
E
E
E
E
E
E
E
E
E
E
E
E
E
E
E
E
E
E
E
E
E
E
E
E
E
E
E
E
E
E
E
E
E
E
E
E
E
E
E
E
E
E
E
E
E
E
E
E
E
E
E
E
E
E
E
E
D
D
D
a
a
a
a
a
a
a
"}
(34,1,1) = {"
a
a
a
a
a
a
a
q
q
q
q
q
q
H
H
H
H
H
H
H
D
l
Y
Y
Y
Y
Y
Y
Y
Y
l
D
D
D
D
D
E
E
E
E
E
E
E
E
E
E
E
E
E
E
E
E
E
E
E
E
E
E
E
E
E
E
E
E
E
E
E
E
E
E
E
E
E
E
E
E
E
E
E
E
E
E
E
E
E
E
E
E
E
E
E
E
E
E
E
E
E
E
E
E
E
E
E
E
D
D
D
a
a
a
a
a
a
a
"}
(35,1,1) = {"
a
a
a
a
a
a
a
q
q
q
q
q
H
H
H
H
H
H
H
D
l
l
Y
Y
Y
Y
Y
Y
Y
l
l
D
D
D
D
E
E
E
E
E
E
E
E
E
E
E
E
E
E
E
E
E
E
E
E
E
E
E
E
E
E
E
E
E
E
E
E
E
E
E
E
E
E
E
E
E
E
E
E
E
E
E
E
E
E
E
E
E
E
E
E
E
E
E
E
E
E
E
E
E
E
E
E
D
D
D
D
a
a
a
a
a
a
a
"}
(36,1,1) = {"
a
a
a
a
a
a
a
q
q
q
q
q
H
H
H
H
H
D
D
D
l
Y
Y
Y
Y
Y
Y
Y
Y
l
D
D
D
D
D
E
E
E
E
E
E
E
E
E
E
E
E
E
E
E
E
E
E
E
E
E
E
E
E
E
E
E
E
E
E
E
E
E
E
E
E
E
E
E
E
E
E
E
E
E
E
E
E
E
E
E
E
E
E
E
E
E
E
E
E
E
E
E
E
E
E
E
E
D
D
D
D
a
a
a
a
a
a
a
"}
(37,1,1) = {"
a
a
a
a
a
a
a
q
q
q
q
q
H
H
H
H
D
D
D
D
l
Y
Y
Y
Y
Y
Y
Y
Y
l
D
D
D
D
D
E
E
E
E
E
E
E
E
E
E
E
E
E
E
E
E
E
E
E
E
E
E
E
E
E
E
E
E
E
E
E
E
E
E
E
E
E
E
E
E
E
E
E
E
E
E
E
E
E
E
E
E
E
E
E
E
E
E
E
E
E
E
E
E
E
E
E
E
D
D
D
D
a
a
a
a
a
a
a
"}
(38,1,1) = {"
a
a
a
a
a
a
a
q
q
q
q
q
H
H
D
D
D
D
D
D
l
Y
Y
Y
Y
Y
Y
Y
l
l
D
D
D
D
E
E
E
E
E
E
E
E
E
E
E
E
E
E
E
E
E
E
E
E
E
E
E
E
E
E
E
E
E
E
E
E
E
E
E
E
E
E
E
E
E
E
E
E
E
E
E
E
E
E
E
E
E
E
E
E
E
E
E
E
E
E
E
E
E
E
E
E
E
D
D
D
D
a
a
a
a
a
a
a
"}
(39,1,1) = {"
a
a
a
a
a
a
a
q
q
q
q
H
D
D
D
D
D
D
D
D
l
Y
Y
Y
Y
Y
Y
Y
l
l
D
D
D
D
E
E
E
E
E
E
E
E
E
E
E
E
E
E
E
E
E
E
E
E
E
E
E
E
E
E
E
E
E
E
E
E
E
E
E
E
E
E
E
E
E
E
E
E
E
E
E
E
E
E
E
E
E
E
E
E
E
E
E
E
E
E
E
E
E
E
E
E
E
D
D
D
D
a
a
a
a
a
a
a
"}
(40,1,1) = {"
a
a
a
a
a
a
a
q
q
q
q
D
D
D
D
D
D
D
D
D
l
Y
Y
Y
Y
Y
Y
Y
l
l
D
D
D
D
E
E
E
E
E
E
E
E
E
E
E
E
E
E
E
E
E
E
E
E
E
E
E
E
E
E
E
E
E
E
E
E
E
E
E
E
E
E
E
E
E
E
E
E
E
E
E
E
E
E
E
E
E
E
E
E
E
E
E
E
E
E
E
E
E
E
E
E
E
D
D
D
D
a
a
a
a
a
a
a
"}
(41,1,1) = {"
a
a
a
a
a
a
a
q
q
q
q
D
D
D
D
D
D
D
D
D
l
Y
Y
Y
Y
Y
Y
Y
Y
l
D
D
D
D
E
E
E
E
E
E
E
E
E
E
E
E
E
E
E
E
E
E
E
E
E
E
E
E
E
E
E
E
E
E
E
E
E
E
E
E
E
E
E
E
E
E
E
E
E
E
E
E
E
E
E
E
E
E
E
E
E
E
E
E
E
E
E
E
E
E
E
E
E
D
D
D
D
a
a
a
a
a
a
a
"}
(42,1,1) = {"
a
a
a
a
a
a
a
q
q
q
D
D
D
D
E
E
D
D
D
D
l
Y
Y
Y
Y
Y
Y
Y
Y
l
D
D
D
D
E
E
E
E
E
E
E
E
E
E
E
E
E
E
E
E
E
E
E
E
E
E
E
E
E
E
E
E
E
E
E
E
E
E
E
E
E
E
E
E
E
E
E
E
E
E
E
E
E
E
E
E
E
E
E
E
E
E
E
E
E
E
E
E
E
E
E
E
D
D
D
D
D
a
a
a
a
a
a
a
"}
(43,1,1) = {"
a
a
a
a
a
a
a
q
q
q
D
D
D
E
E
E
D
D
D
D
l
Y
Y
Y
Y
Y
Y
Y
Y
l
l
D
D
D
E
E
E
E
E
E
E
E
E
E
E
E
E
E
E
E
E
E
E
E
E
E
E
E
E
E
E
E
E
E
E
E
E
E
E
E
E
E
E
E
E
E
E
E
E
E
E
E
E
E
E
E
E
E
E
E
E
E
E
E
E
E
E
E
E
E
E
E
D
D
D
D
D
a
a
a
a
a
a
a
"}
(44,1,1) = {"
a
a
a
a
a
a
a
q
q
D
D
D
E
E
E
E
E
D
D
D
l
l
Y
Y
Y
Y
Y
Y
Y
Y
l
D
D
D
D
E
E
E
E
E
E
E
E
E
E
E
E
E
E
E
E
E
E
E
E
E
E
E
E
E
E
E
E
E
E
E
E
E
E
E
E
E
E
E
E
E
E
E
E
E
E
E
E
E
E
E
E
E
E
E
E
E
E
E
E
E
E
E
E
E
E
E
D
D
D
D
D
a
a
a
a
a
a
a
"}
(45,1,1) = {"
a
a
a
a
a
a
a
q
q
D
D
D
E
E
E
E
E
D
D
D
l
l
Y
Y
Y
Y
Y
Y
Y
Y
l
D
D
D
D
E
E
E
E
E
E
E
E
E
E
E
E
E
E
E
E
E
E
E
E
E
E
E
E
E
E
E
E
E
E
E
E
E
E
E
E
E
E
E
E
E
E
E
E
E
E
E
E
E
E
E
E
E
E
E
E
E
E
E
E
E
E
E
E
E
E
E
D
D
D
D
D
a
a
a
a
a
a
a
"}
(46,1,1) = {"
a
a
a
a
a
a
a
q
q
D
D
E
E
E
E
E
E
D
D
D
D
l
Y
Y
Y
Y
Y
Y
Y
Y
l
D
D
D
D
E
E
E
E
E
E
E
E
E
E
E
E
E
E
E
E
E
E
E
E
E
E
E
E
E
E
E
E
E
E
E
E
E
E
E
E
E
E
E
E
E
E
E
E
E
E
E
E
E
E
E
E
E
E
E
E
E
E
E
E
E
E
E
E
E
E
E
D
D
D
D
D
a
a
a
a
a
a
a
"}
(47,1,1) = {"
a
a
a
a
a
a
a
q
q
D
D
E
E
E
E
E
E
D
D
D
D
l
l
Y
Y
Y
Y
Y
Y
Y
l
l
D
D
D
E
E
E
E
E
E
E
E
E
E
E
E
E
E
E
E
E
E
E
E
E
E
E
E
E
E
E
E
E
E
E
E
E
E
E
E
E
E
E
E
E
E
E
E
E
E
E
E
E
E
E
E
E
E
E
E
E
E
E
E
E
E
E
E
E
E
E
D
D
D
D
D
a
a
a
a
a
a
a
"}
(48,1,1) = {"
a
a
a
a
a
a
a
q
q
D
D
E
E
E
E
E
E
D
D
D
D
l
l
Y
Y
Y
Y
Y
Y
Y
Y
l
D
D
D
D
E
E
E
E
E
E
E
E
E
E
E
E
E
E
E
E
E
E
E
E
E
E
E
E
E
E
E
E
E
E
E
E
E
E
E
E
E
E
E
E
E
E
E
E
E
E
E
E
E
E
E
E
E
E
E
E
E
E
E
E
E
E
E
E
E
E
D
D
D
D
D
a
a
a
a
a
a
a
"}
(49,1,1) = {"
a
a
a
a
a
a
a
q
q
D
D
E
E
E
E
E
E
D
D
D
D
D
l
l
Y
Y
Y
Y
Y
Y
l
l
D
D
D
D
E
E
E
E
E
E
E
E
E
E
E
E
E
E
E
E
E
E
E
E
E
E
E
E
E
E
E
E
E
E
E
E
E
E
E
E
E
E
E
E
E
E
E
E
E
E
E
E
E
E
E
E
E
E
E
E
E
E
E
E
E
E
E
E
E
E
D
D
D
D
D
a
a
a
a
a
a
a
"}
(50,1,1) = {"
a
a
a
a
a
a
a
q
q
D
D
E
E
E
E
E
E
E
D
D
D
D
l
l
Y
Y
Y
Y
Y
Y
l
D
D
D
D
D
E
E
E
E
E
E
E
E
E
E
E
E
E
E
E
E
E
E
E
E
E
E
E
E
E
E
E
E
E
E
E
E
E
E
E
E
E
E
E
E
E
E
E
E
E
E
E
E
E
E
E
E
E
E
E
E
E
E
E
E
E
E
E
E
E
E
D
D
D
D
D
a
a
a
a
a
a
a
"}
(51,1,1) = {"
a
a
a
a
a
a
a
q
q
D
D
E
E
E
E
E
E
E
D
D
D
D
D
l
Y
Y
Y
Y
Y
Y
l
D
D
D
D
D
E
E
E
E
E
E
E
E
E
E
E
E
E
E
E
E
E
E
E
E
E
E
E
E
E
E
E
E
E
E
E
E
E
E
E
E
E
E
E
E
E
E
E
E
E
E
E
E
E
E
E
E
E
E
E
E
E
E
E
E
E
E
E
E
E
E
D
D
D
D
D
a
a
a
a
a
a
a
"}
(52,1,1) = {"
a
a
a
a
a
a
a
q
q
D
E
E
E
E
E
E
E
E
D
D
D
D
D
l
l
Y
Y
Y
Y
Y
l
l
D
D
D
D
D
E
E
E
E
E
E
E
E
E
E
E
E
E
E
E
E
E
E
E
E
E
E
E
E
E
E
E
E
E
E
E
E
E
E
E
E
E
E
E
E
E
E
E
E
E
E
E
E
E
E
E
E
E
E
E
E
E
E
E
E
E
E
E
E
D
D
D
D
D
D
a
a
a
a
a
a
a
"}
(53,1,1) = {"
a
a
a
a
a
a
a
q
q
D
E
E
E
E
E
E
E
E
E
D
D
D
D
l
l
Y
Y
Y
Y
Y
Y
l
D
D
D
D
D
E
E
E
E
E
E
E
E
E
E
E
E
E
E
E
E
E
E
E
E
E
E
E
E
E
E
E
E
E
E
E
E
E
E
E
E
E
E
E
E
E
E
E
E
E
E
E
E
E
E
E
E
E
E
E
E
E
E
E
E
E
E
E
E
D
D
D
D
D
D
a
a
a
a
a
a
a
"}
(54,1,1) = {"
a
a
a
a
a
a
a
q
q
D
E
E
E
E
E
E
E
E
E
E
D
D
D
D
l
l
Y
Y
Y
Y
Y
l
D
D
D
D
D
E
E
E
E
E
E
E
E
E
E
E
E
E
E
E
E
E
E
E
E
E
E
E
E
E
E
E
E
E
E
E
E
E
E
E
E
E
E
E
E
E
E
E
E
E
E
E
E
E
E
E
E
E
E
E
E
E
E
E
E
E
E
E
E
D
D
D
D
D
D
a
a
a
a
a
a
a
"}
(55,1,1) = {"
a
a
a
a
a
a
a
q
q
D
E
E
E
E
E
E
E
E
E
E
D
D
D
D
l
l
Y
Y
Y
Y
Y
l
D
D
D
D
D
E
E
E
E
E
E
E
E
E
E
E
E
E
E
E
E
E
E
E
E
E
E
E
E
E
E
E
E
E
E
E
E
E
E
E
E
E
E
E
E
E
E
E
E
E
E
E
E
E
E
E
E
E
E
E
E
E
E
E
E
E
E
E
E
D
D
D
D
D
D
a
a
a
a
a
a
a
"}
(56,1,1) = {"
a
a
a
a
a
a
a
q
q
D
E
E
E
E
E
E
E
E
E
E
E
D
D
D
D
l
Y
Y
Y
Y
Y
l
D
D
D
D
D
E
E
E
E
E
E
E
E
E
E
E
E
E
E
E
E
E
E
E
E
E
E
E
E
E
E
E
E
E
E
E
E
E
E
E
E
E
E
E
E
E
E
E
E
E
E
E
E
E
E
E
E
E
E
E
E
E
E
E
E
E
E
E
E
E
D
D
D
D
D
a
a
a
a
a
a
a
"}
(57,1,1) = {"
a
a
a
a
a
a
a
q
q
D
E
E
E
E
E
E
E
E
E
E
E
D
D
D
D
l
Y
Y
Y
Y
Y
l
l
D
D
D
D
E
E
E
E
E
E
E
E
E
E
E
E
E
E
E
E
E
E
E
E
E
E
E
E
E
E
E
E
E
E
E
E
E
E
E
E
E
E
E
E
E
E
E
E
E
E
E
E
E
E
E
E
E
E
E
E
E
E
E
E
E
E
E
E
E
D
D
D
D
D
a
a
a
a
a
a
a
"}
(58,1,1) = {"
a
a
a
a
a
a
a
q
q
D
E
E
E
E
E
E
E
E
E
E
E
D
D
D
D
l
Y
Y
Y
Y
Y
Y
l
D
D
D
D
E
E
E
E
E
E
E
E
E
E
E
E
E
E
E
E
E
E
E
E
E
E
E
E
E
E
E
E
E
E
E
E
E
E
E
E
E
E
E
E
E
E
E
E
E
E
E
E
E
E
E
E
E
E
E
E
E
E
E
E
E
E
E
E
E
D
D
D
D
D
a
a
a
a
a
a
a
"}
(59,1,1) = {"
a
a
a
a
a
a
a
q
q
D
E
E
E
E
E
E
E
E
E
E
E
D
D
D
D
l
Y
Y
Y
Y
Y
Y
l
l
D
D
D
E
E
E
E
E
E
E
E
E
E
E
E
E
E
E
E
E
E
E
E
E
E
E
E
E
E
E
E
E
E
E
E
E
E
E
E
E
E
E
E
E
E
E
E
E
E
E
E
E
E
E
E
E
E
E
E
E
E
E
E
E
E
E
E
E
D
D
D
D
D
a
a
a
a
a
a
a
"}
(60,1,1) = {"
a
a
a
a
a
a
a
q
q
D
E
E
E
E
E
E
E
E
E
E
E
D
D
D
D
l
Y
Y
Y
Y
Y
Y
Y
l
D
D
D
E
E
E
E
E
E
E
E
E
E
E
E
E
E
E
E
E
E
E
E
E
E
E
E
E
E
E
E
E
E
E
E
E
E
E
E
E
E
E
E
E
E
E
E
E
E
E
E
E
E
E
E
E
E
E
E
E
E
E
E
E
E
E
E
E
D
D
D
D
D
a
a
a
a
a
a
a
"}
(61,1,1) = {"
a
a
a
a
a
a
a
q
D
D
E
E
E
E
E
E
E
E
E
E
E
E
D
D
D
l
Y
Y
Y
Y
Y
Y
Y
l
D
D
D
E
E
E
E
E
E
E
E
E
E
E
E
E
E
E
E
E
E
E
E
E
E
E
E
E
E
E
E
E
E
E
E
E
E
E
E
E
E
E
E
E
E
E
E
E
E
E
E
E
E
E
E
E
E
E
E
E
E
E
E
E
E
E
E
E
E
D
D
D
D
a
a
a
a
a
a
a
"}
(62,1,1) = {"
a
a
a
a
a
a
a
q
D
D
E
E
E
E
E
E
E
E
E
E
E
E
D
D
D
l
Y
Y
Y
Y
Y
Y
Y
l
D
D
D
D
E
E
E
E
E
E
E
E
E
E
E
E
E
E
E
E
E
E
E
E
E
E
E
E
E
E
E
E
E
E
E
E
E
E
E
E
E
E
E
E
E
E
E
E
E
E
E
E
E
E
E
E
E
E
E
E
E
E
E
E
E
E
E
E
E
D
D
D
D
a
a
a
a
a
a
a
"}
(63,1,1) = {"
a
a
a
a
a
a
a
q
D
D
E
E
E
E
E
E
E
E
E
E
E
E
D
D
D
l
Y
Y
Y
Y
Y
Y
Y
l
D
D
D
D
E
E
E
E
E
E
E
E
E
E
E
E
E
E
E
E
E
E
E
E
E
E
E
E
E
E
E
E
E
E
E
E
E
E
E
E
E
E
E
E
E
E
E
E
E
E
E
E
E
E
E
E
E
E
E
E
E
E
E
E
E
E
E
E
E
D
D
D
D
a
a
a
a
a
a
a
"}
(64,1,1) = {"
a
a
a
a
a
a
a
q
D
D
E
E
E
E
E
E
E
E
E
E
E
E
D
D
D
l
Y
Y
Y
Y
Y
Y
Y
l
D
D
D
D
E
E
E
E
E
E
E
E
E
E
E
E
E
E
E
E
E
E
E
E
E
E
E
E
E
E
E
E
E
E
E
E
E
E
E
E
E
E
E
E
E
E
E
E
E
E
E
E
E
E
E
E
E
E
E
E
E
E
E
E
E
E
E
E
E
D
D
D
D
a
a
a
a
a
a
a
"}
(65,1,1) = {"
a
a
a
a
a
a
a
q
q
D
E
E
E
E
E
E
E
E
E
E
E
E
D
D
l
l
Y
Y
Y
Y
Y
Y
Y
l
D
D
D
D
E
E
E
E
E
E
E
E
E
E
E
E
E
E
E
E
E
E
E
E
E
E
E
E
E
E
E
E
E
E
E
E
E
E
E
E
E
E
E
E
E
E
E
E
E
E
E
E
E
E
E
E
E
E
E
E
E
E
E
E
E
E
E
E
E
D
D
D
D
a
a
a
a
a
a
a
"}
(66,1,1) = {"
a
a
a
a
a
a
a
q
q
D
E
E
E
E
E
E
E
E
E
E
E
E
D
D
l
Y
Y
Y
Y
Y
Y
Y
Y
l
D
D
D
D
E
E
E
E
E
E
E
E
E
E
E
E
E
E
E
E
E
E
E
E
E
E
E
E
E
E
E
E
E
E
E
E
E
E
E
E
E
E
E
E
E
E
E
E
E
E
E
E
E
E
E
E
E
E
E
E
E
E
E
E
E
E
E
E
E
D
D
D
D
a
a
a
a
a
a
a
"}
(67,1,1) = {"
a
a
a
a
a
a
a
q
q
D
E
E
E
E
E
E
E
E
E
E
E
E
D
D
l
Y
Y
Y
Y
Y
Y
Y
Y
l
D
D
D
D
E
E
E
E
E
E
E
E
E
E
E
E
E
E
E
E
E
E
E
E
E
E
E
E
E
E
E
E
E
E
E
E
E
E
E
E
E
E
E
E
E
E
E
E
E
E
E
E
E
E
E
E
E
E
E
E
E
E
E
E
E
E
E
E
E
D
D
D
D
a
a
a
a
a
a
a
"}
(68,1,1) = {"
a
a
a
a
a
a
a
q
q
D
E
E
E
E
E
E
E
E
E
E
E
D
D
D
l
Y
Y
Y
Y
Y
Y
Y
Y
l
D
D
D
D
E
E
E
E
E
E
E
E
E
E
E
E
E
E
E
E
E
E
E
E
E
E
E
E
E
E
E
E
E
E
E
E
E
E
E
E
E
E
E
E
E
E
E
E
E
E
E
E
E
E
E
E
E
E
E
E
E
E
E
E
E
E
E
E
E
D
D
D
D
a
a
a
a
a
a
a
"}
(69,1,1) = {"
a
a
a
a
a
a
a
q
q
D
D
E
E
E
E
E
E
E
E
E
E
D
D
D
l
Y
Y
Y
Y
Y
Y
Y
l
l
D
D
D
D
E
E
E
E
E
E
E
E
E
E
E
E
E
E
E
E
E
E
E
E
E
E
E
E
E
E
E
E
E
E
E
E
E
E
E
E
E
E
E
E
E
E
E
E
E
E
E
E
E
E
E
E
E
E
E
E
E
E
E
E
E
E
E
E
E
E
D
D
D
a
a
a
a
a
a
a
"}
(70,1,1) = {"
a
a
a
a
a
a
a
q
q
D
D
E
E
E
E
E
E
E
E
E
E
D
D
D
l
Y
Y
Y
Y
Y
Y
Y
l
D
D
D
D
D
E
E
E
E
E
E
E
E
E
E
E
E
E
E
E
E
E
E
E
E
E
E
E
E
E
E
E
E
E
E
E
E
E
E
E
E
E
E
E
E
E
E
E
E
E
E
E
E
E
E
E
E
E
E
E
E
E
E
E
E
E
E
E
E
E
E
D
D
D
a
a
a
a
a
a
a
"}
(71,1,1) = {"
a
a
a
a
a
a
a
q
q
D
D
E
E
E
E
E
E
E
E
E
E
D
D
D
l
Y
Y
Y
Y
Y
Y
Y
l
D
D
D
D
D
E
E
E
E
E
E
E
E
E
E
E
E
E
E
E
E
E
E
E
E
E
E
E
E
E
E
E
E
E
E
E
E
E
E
E
E
E
E
E
E
E
E
E
E
E
E
E
E
E
E
E
E
E
E
E
E
E
E
E
E
E
E
E
E
E
E
D
D
D
a
a
a
a
a
a
a
"}
(72,1,1) = {"
a
a
a
a
a
a
a
q
q
D
D
E
E
E
E
E
E
E
E
E
E
D
D
D
l
l
Y
Y
Y
Y
Y
Y
l
D
D
D
D
D
E
E
E
E
E
E
E
E
E
E
E
E
E
E
E
E
E
E
E
E
E
E
E
E
E
E
E
E
E
E
E
E
E
E
E
E
E
E
E
E
E
E
E
E
E
E
E
E
E
E
E
E
E
E
E
E
E
E
E
E
E
E
E
E
E
E
D
D
D
a
a
a
a
a
a
a
"}
(73,1,1) = {"
a
a
a
a
a
a
a
q
q
D
D
E
E
E
E
E
E
E
E
E
E
D
D
D
D
l
Y
Y
Y
Y
Y
l
l
D
D
D
D
D
E
E
E
E
E
E
E
E
E
E
E
E
E
E
E
E
E
E
E
E
E
E
E
E
E
E
E
E
E
E
E
E
E
E
E
E
E
E
E
E
E
E
E
E
E
E
E
E
E
E
E
E
E
E
E
E
E
E
E
E
E
E
E
E
E
E
D
D
D
a
a
a
a
a
a
a
"}
(74,1,1) = {"
a
a
a
a
a
a
a
q
q
D
D
E
E
E
E
E
E
E
E
E
E
D
D
D
D
l
Y
Y
Y
Y
Y
l
D
D
D
D
D
D
E
E
E
E
E
E
E
E
E
E
E
E
E
E
E
E
E
E
E
E
E
E
E
E
E
E
E
E
E
E
E
E
E
E
E
E
E
E
E
E
E
E
E
E
E
E
E
E
E
E
E
E
E
E
E
E
E
E
E
E
E
E
E
E
E
E
D
D
D
a
a
a
a
a
a
a
"}
(75,1,1) = {"
a
a
a
a
a
a
a
q
q
D
D
D
E
E
E
E
E
E
E
E
E
D
D
D
D
D
l
Y
Y
Y
l
l
D
D
D
D
D
E
E
E
E
E
E
E
E
E
E
E
E
E
E
E
E
E
E
E
E
E
E
E
E
E
E
E
E
E
E
E
E
E
E
E
E
E
E
E
E
E
E
E
E
E
E
E
E
E
E
E
E
E
E
E
E
E
E
E
E
E
E
E
E
E
E
D
D
D
D
a
a
a
a
a
a
a
"}
(76,1,1) = {"
a
a
a
a
a
a
a
q
q
D
D
D
E
E
E
E
E
E
E
E
E
D
D
D
D
D
l
Y
Y
l
l
D
D
D
D
D
D
E
E
E
E
E
E
E
E
E
E
E
E
E
E
E
E
E
E
E
E
E
E
E
E
E
E
E
E
E
E
E
E
E
E
E
E
E
E
E
E
E
E
E
E
E
E
E
E
E
E
E
E
E
E
E
E
E
E
E
E
E
E
E
E
E
E
D
D
D
D
a
a
a
a
a
a
a
"}
(77,1,1) = {"
a
a
a
a
a
a
a
q
q
D
D
D
E
E
E
E
E
E
E
E
E
D
D
D
D
D
l
l
l
l
D
D
D
D
D
D
E
E
E
E
E
E
E
E
E
E
E
E
E
E
E
E
E
E
E
E
E
E
E
E
E
E
E
E
E
E
E
E
E
E
E
E
E
E
E
E
E
E
E
E
E
E
E
E
E
E
E
E
E
E
E
E
E
E
E
E
E
E
E
E
E
E
E
D
D
D
D
a
a
a
a
a
a
a
"}
(78,1,1) = {"
a
a
a
a
a
a
a
q
q
D
D
D
E
E
E
E
E
E
E
E
E
E
D
D
D
D
D
D
D
D
D
D
D
D
D
D
E
E
E
E
E
E
E
E
E
E
E
E
E
E
E
E
E
E
E
E
E
E
E
E
E
E
E
E
E
E
E
E
E
E
E
E
E
E
E
E
E
E
E
E
E
E
E
E
E
E
E
E
E
E
E
E
E
E
E
E
E
E
E
E
E
E
E
D
D
D
D
a
a
a
a
a
a
a
"}
(79,1,1) = {"
a
a
a
a
a
a
a
q
q
D
D
D
E
E
E
E
E
E
E
E
E
E
E
D
D
D
D
D
D
D
D
D
D
D
E
E
E
E
E
E
E
E
E
E
E
E
E
E
E
E
E
E
E
E
E
E
E
E
E
E
E
E
E
E
E
E
E
E
E
E
E
E
E
E
E
E
E
E
E
E
E
E
E
E
E
E
E
E
E
E
E
E
E
E
E
E
E
E
E
E
E
E
E
D
D
D
D
a
a
a
a
a
a
a
"}
(80,1,1) = {"
a
a
a
a
a
a
a
q
q
D
D
D
E
E
E
E
E
E
E
E
E
E
E
E
E
D
D
D
D
D
D
D
D
E
E
E
E
E
E
E
E
E
E
E
E
E
E
E
E
E
E
E
E
E
E
E
E
E
E
E
E
E
E
E
E
E
E
E
E
E
E
E
E
E
E
E
E
E
E
E
E
E
E
E
E
E
E
E
E
E
E
E
E
E
E
E
E
E
E
E
E
E
E
D
D
D
D
a
a
a
a
a
a
a
"}
(81,1,1) = {"
a
a
a
a
a
a
a
q
D
D
D
D
E
E
E
E
E
E
E
E
E
E
E
E
E
E
E
E
E
E
E
E
E
E
E
E
E
E
E
E
E
E
E
E
E
E
E
E
E
E
E
E
E
E
E
E
E
E
E
E
E
E
E
E
E
E
E
E
E
E
E
E
E
E
E
E
E
E
E
E
E
E
E
E
E
E
E
E
E
E
E
E
E
E
E
E
E
E
E
E
E
E
E
D
D
D
D
a
a
a
a
a
a
a
"}
(82,1,1) = {"
a
a
a
a
a
a
a
q
D
D
D
D
E
E
E
E
E
E
E
E
E
E
E
E
E
E
E
E
E
E
E
E
E
E
E
E
E
E
E
E
E
E
E
E
E
E
E
E
E
E
E
E
E
E
E
E
E
E
E
E
E
E
E
E
E
E
E
E
E
E
E
E
E
E
E
E
E
E
E
E
E
E
E
E
E
E
E
E
E
E
E
E
E
E
E
E
E
E
E
E
E
E
E
D
D
D
D
a
a
a
a
a
a
a
"}
(83,1,1) = {"
a
a
a
a
a
a
a
q
D
D
D
D
E
E
E
E
E
E
E
E
E
E
E
E
E
E
E
E
E
E
E
E
E
E
E
E
E
E
E
E
E
E
E
E
E
E
E
E
E
E
E
E
E
E
E
E
E
E
E
E
E
E
E
E
E
E
E
E
E
E
E
E
E
E
E
E
E
E
E
E
E
E
E
E
E
E
E
E
E
E
E
E
E
E
E
E
E
E
E
E
E
E
E
D
D
D
D
a
a
a
a
a
a
a
"}
(84,1,1) = {"
a
a
a
a
a
a
a
q
D
D
D
D
E
E
E
E
E
E
E
E
E
E
E
E
E
E
E
E
E
E
E
E
E
E
E
E
E
E
E
E
E
E
E
E
E
E
E
E
E
E
E
E
E
E
E
E
E
E
E
E
E
E
E
E
E
E
E
E
E
E
E
E
E
E
E
E
E
E
E
E
E
E
E
E
E
E
E
E
E
E
E
E
E
E
E
E
E
E
E
E
E
E
E
D
D
D
D
a
a
a
a
a
a
a
"}
(85,1,1) = {"
a
a
a
a
a
a
a
q
D
D
D
D
E
E
E
E
E
E
E
E
E
E
E
E
E
E
E
E
E
E
E
E
E
E
E
E
E
E
E
E
E
E
E
E
E
E
E
E
E
E
E
E
E
E
E
E
E
E
E
E
E
E
E
E
E
E
E
E
E
E
E
E
E
E
E
E
E
E
E
E
E
E
E
E
E
E
E
E
E
E
E
E
E
E
E
E
E
E
E
E
E
E
D
D
D
D
D
a
a
a
a
a
a
a
"}
(86,1,1) = {"
a
a
a
a
a
a
a
q
D
D
D
D
E
E
E
E
E
E
E
E
E
E
E
E
E
E
E
E
E
E
E
E
E
E
E
E
E
E
E
E
E
E
E
E
E
E
E
E
E
E
E
E
E
E
E
E
E
E
E
E
E
E
E
E
E
E
E
E
E
E
E
E
E
E
E
E
E
E
E
E
E
E
E
E
E
E
E
E
E
E
E
E
E
E
E
E
E
E
E
E
E
E
D
D
D
D
D
a
a
a
a
a
a
a
"}
(87,1,1) = {"
a
a
a
a
a
a
a
q
D
D
D
D
E
E
E
E
E
E
E
E
E
E
E
E
E
E
E
E
E
E
E
E
E
E
E
E
E
E
E
E
E
E
E
E
E
E
E
E
E
E
E
E
E
E
E
E
E
E
E
E
E
E
E
E
E
E
E
E
E
E
E
E
E
E
E
E
E
E
E
E
E
E
E
E
E
E
E
E
E
E
E
E
E
E
E
E
E
E
E
E
E
E
D
D
D
D
D
a
a
a
a
a
a
a
"}
(88,1,1) = {"
a
a
a
a
a
a
a
D
D
D
D
E
E
E
E
E
E
E
E
E
E
E
E
E
E
E
E
E
E
E
E
E
E
E
E
E
E
E
E
E
E
E
E
E
E
E
E
E
E
E
E
E
E
E
E
E
E
E
E
E
E
E
E
E
E
E
E
E
E
E
E
E
E
E
E
E
E
E
E
E
E
E
E
E
E
E
E
E
E
E
E
E
E
E
E
E
E
E
E
E
E
E
D
D
D
D
D
a
a
a
a
a
a
a
"}
(89,1,1) = {"
a
a
a
a
a
a
a
D
D
D
D
E
E
E
E
E
E
E
E
E
E
E
E
E
E
E
E
E
E
E
E
E
E
E
E
E
E
E
E
E
E
E
E
E
E
E
E
E
E
E
E
E
E
E
E
E
E
E
E
E
E
E
E
E
E
E
E
E
E
E
E
E
E
E
E
E
E
E
E
E
E
E
E
E
E
E
E
E
E
E
E
E
E
E
E
E
E
E
E
E
E
E
D
D
D
D
D
a
a
a
a
a
a
a
"}
(90,1,1) = {"
a
a
a
a
a
a
a
D
D
D
D
E
E
E
E
E
E
E
E
E
E
E
E
E
E
E
E
E
E
E
E
E
E
E
E
E
E
E
E
E
E
E
E
E
E
E
E
E
E
E
E
E
E
E
E
E
E
E
E
E
E
E
E
E
E
E
E
E
E
E
E
E
E
E
E
E
E
E
E
E
E
E
E
E
E
E
E
E
E
E
E
E
E
E
E
E
E
E
E
E
E
E
D
D
D
D
D
a
a
a
a
a
a
a
"}
(91,1,1) = {"
a
a
a
a
a
a
a
D
D
D
D
E
E
E
E
E
E
E
E
E
E
E
E
E
E
E
E
E
E
E
E
E
E
E
E
E
E
E
E
E
E
E
E
E
E
E
E
E
E
E
E
E
E
E
E
E
E
E
E
E
E
E
E
E
E
E
E
E
E
E
E
E
E
E
E
E
E
E
E
E
E
E
E
E
E
E
E
E
E
E
E
E
E
E
E
E
E
E
E
E
E
E
D
D
D
D
D
a
a
a
a
a
a
a
"}
(92,1,1) = {"
a
a
a
a
a
a
a
D
D
D
D
E
E
E
E
E
E
E
E
E
E
E
E
E
E
E
E
E
E
E
E
E
E
E
E
E
E
E
E
E
E
E
E
E
E
E
E
E
E
E
E
E
E
E
E
E
E
E
E
E
E
E
E
E
E
E
E
E
E
E
E
E
E
E
E
E
E
E
E
E
E
E
E
E
E
E
E
E
E
E
E
E
E
E
E
E
E
E
E
E
E
E
E
D
D
D
D
a
a
a
a
a
a
a
"}
(93,1,1) = {"
a
a
a
a
a
a
a
D
D
D
D
E
E
E
E
E
E
E
E
E
E
E
E
E
E
E
E
E
E
E
E
E
E
E
E
E
E
E
E
E
E
E
E
E
E
E
E
E
E
E
E
E
E
E
E
E
E
E
E
E
E
E
E
E
E
E
E
E
E
E
E
E
E
E
E
E
E
E
E
E
E
E
E
E
E
E
E
E
E
E
E
E
E
E
E
E
E
E
E
E
E
E
E
D
D
D
D
a
a
a
a
a
a
a
"}
(94,1,1) = {"
a
a
a
a
a
a
a
D
D
D
D
E
E
E
E
E
E
E
E
E
E
E
E
E
E
E
E
E
E
E
E
E
E
E
E
E
E
E
E
E
E
E
E
E
E
E
E
E
E
E
E
E
E
E
E
E
E
E
E
E
E
E
E
E
E
E
E
E
E
E
E
E
E
E
E
E
E
E
E
E
E
E
E
E
E
E
E
E
E
E
E
E
E
E
E
E
E
E
E
E
E
E
E
D
D
D
D
a
a
a
a
a
a
a
"}
(95,1,1) = {"
a
a
a
a
a
a
a
D
D
D
D
E
E
E
E
E
E
E
E
E
E
E
E
E
E
E
E
E
E
E
E
E
E
E
E
E
E
E
E
E
E
E
E
E
E
E
E
E
E
E
E
E
E
E
E
E
E
E
E
E
E
E
E
E
E
E
E
E
E
E
E
E
E
E
E
E
E
E
E
E
E
E
E
E
E
E
E
E
E
E
E
E
E
E
E
E
E
E
E
E
E
E
E
D
D
D
D
a
a
a
a
a
a
a
"}
(96,1,1) = {"
a
a
a
a
a
a
a
D
D
D
D
E
E
E
E
E
E
E
E
E
E
E
E
E
E
E
E
E
E
E
E
E
E
E
E
E
E
E
E
E
E
E
E
E
E
E
E
E
E
E
E
E
E
E
E
E
E
E
E
E
E
E
E
E
E
E
E
E
E
E
E
E
E
E
E
E
E
E
E
E
E
E
E
E
E
E
E
E
E
E
E
E
E
E
E
E
E
E
E
E
E
E
E
D
D
D
D
a
a
a
a
a
a
a
"}
(97,1,1) = {"
a
a
a
a
a
a
a
D
D
D
D
E
E
E
E
E
E
E
E
E
E
E
E
E
E
E
E
E
E
E
E
E
E
E
E
E
E
E
E
E
E
E
E
E
E
E
E
E
E
E
E
E
E
E
E
E
E
E
E
E
E
E
E
E
E
E
E
E
E
E
E
E
E
E
E
E
E
E
E
E
E
E
E
E
E
E
E
E
E
E
E
E
E
E
E
E
E
E
E
E
E
E
E
D
D
D
D
a
a
a
a
a
a
a
"}
(98,1,1) = {"
a
a
a
a
a
a
a
D
D
D
D
E
E
E
E
E
E
E
E
E
E
E
E
E
E
E
E
E
E
E
E
E
E
E
E
E
E
E
E
E
E
E
E
E
E
E
E
E
E
E
E
E
E
E
E
E
E
E
E
E
E
E
E
E
E
E
E
E
E
E
E
E
E
E
E
E
E
E
E
E
E
E
E
E
E
E
E
E
E
E
E
E
E
E
E
E
E
E
E
E
E
E
E
D
D
D
D
a
a
a
a
a
a
a
"}
(99,1,1) = {"
a
a
a
a
a
a
a
D
D
D
D
D
E
E
E
E
E
E
E
E
E
E
E
E
E
E
E
E
E
E
E
E
E
E
E
E
E
E
E
E
E
E
E
E
E
E
E
E
E
E
E
E
E
E
E
E
E
E
E
E
E
E
E
E
E
E
E
E
E
E
E
E
E
E
E
E
E
E
E
E
E
E
E
E
E
E
E
E
E
E
E
E
E
E
E
E
E
E
E
E
E
E
E
D
D
D
D
a
a
a
a
a
a
a
"}
(100,1,1) = {"
a
a
a
a
a
a
a
D
D
D
D
D
E
E
E
E
E
E
E
E
E
E
E
E
E
E
E
E
E
E
E
E
E
E
E
E
E
E
E
E
E
E
E
E
E
E
E
E
E
E
E
E
E
E
E
E
E
E
E
E
E
E
E
E
E
E
E
E
E
E
E
E
E
E
E
E
E
E
E
E
E
E
E
E
E
E
E
E
E
E
E
E
E
E
E
E
E
E
E
E
E
E
E
D
D
D
D
a
a
a
a
a
a
a
"}
(101,1,1) = {"
a
a
a
a
a
a
a
D
D
D
D
D
E
E
E
E
E
E
E
E
E
E
E
E
E
E
E
E
E
E
E
E
E
E
E
E
E
E
E
E
E
E
E
E
E
E
E
D
D
D
E
E
E
E
E
E
E
E
E
E
E
E
E
E
E
E
E
E
E
E
E
E
E
E
E
E
E
E
E
E
E
E
E
E
E
E
E
E
E
E
E
E
E
E
E
E
E
E
E
E
E
E
D
D
D
D
D
a
a
a
a
a
a
a
"}
(102,1,1) = {"
a
a
a
a
a
a
a
D
D
D
D
D
D
E
E
E
E
E
E
E
E
E
E
E
E
E
E
E
E
E
E
E
E
E
E
E
E
D
D
D
D
D
D
D
D
D
D
D
D
D
D
D
D
D
E
E
E
E
E
E
E
E
E
E
E
E
E
E
E
E
E
E
E
E
E
E
E
E
E
E
E
E
E
E
E
E
E
E
E
E
E
E
E
E
E
E
E
E
E
E
D
D
D
D
D
D
D
a
a
a
a
a
a
a
"}
(103,1,1) = {"
a
a
a
a
a
a
a
D
D
D
D
D
D
D
D
E
E
E
E
E
E
E
E
E
E
E
E
E
E
E
E
E
E
E
E
D
D
D
D
D
D
D
D
D
D
D
D
D
D
D
D
D
D
D
D
D
D
E
E
E
E
E
E
E
E
E
E
E
E
E
E
E
E
E
E
E
E
E
E
E
E
E
E
E
E
E
E
E
E
E
E
E
E
E
E
E
E
E
E
D
D
D
D
D
D
D
D
a
a
a
a
a
a
a
"}
(104,1,1) = {"
a
a
a
a
a
a
a
D
D
D
D
D
D
D
D
D
D
E
E
E
E
E
E
E
E
E
E
E
E
E
E
D
D
D
D
D
D
D
D
D
D
D
D
D
D
D
D
D
D
D
D
D
D
D
D
D
D
D
D
D
E
E
E
E
E
E
E
E
E
E
E
E
E
E
D
D
D
D
D
D
D
D
D
D
D
E
E
E
E
E
E
E
E
E
E
E
D
D
D
D
D
D
D
D
D
D
D
a
a
a
a
a
a
a
"}
(105,1,1) = {"
a
a
a
a
a
a
a
D
D
D
D
D
D
D
D
D
D
D
D
D
E
E
E
E
E
E
E
E
D
D
D
D
D
D
D
D
D
D
D
D
D
D
D
D
D
D
D
D
D
D
D
D
D
D
D
D
D
D
D
D
D
D
D
D
D
D
D
D
D
D
D
D
D
D
D
D
D
D
D
D
D
D
D
D
D
D
D
D
D
D
D
D
D
D
D
D
D
D
D
D
D
D
D
D
D
D
D
a
a
a
a
a
a
a
"}
(106,1,1) = {"
a
a
a
a
a
a
a
D
D
D
D
D
D
D
D
D
D
D
D
D
D
D
D
D
D
D
D
D
D
D
D
D
D
D
D
D
D
D
D
D
D
D
D
D
D
D
D
D
D
D
D
D
D
D
D
D
D
D
D
D
D
D
D
D
D
D
D
D
D
D
D
D
D
D
D
D
D
D
D
D
D
D
D
D
D
D
D
D
D
D
D
D
D
D
D
D
D
D
D
D
D
D
D
D
D
D
D
a
a
a
a
a
a
a
"}
(107,1,1) = {"
a
a
a
a
a
a
a
D
D
D
D
D
D
D
D
D
D
D
D
D
D
D
D
D
D
D
D
D
D
D
D
D
D
D
D
D
D
D
D
D
D
D
D
D
D
D
D
D
D
D
D
D
D
D
D
D
D
D
D
D
D
D
D
D
D
D
D
D
D
D
D
D
D
D
D
D
D
D
D
D
D
D
D
D
D
D
D
D
D
D
D
D
D
D
D
D
D
D
D
D
D
D
D
D
D
D
D
a
a
a
a
a
a
a
"}
(108,1,1) = {"
a
a
a
a
a
a
a
a
a
a
a
a
a
a
a
a
a
a
a
a
a
a
a
a
a
a
a
a
a
a
a
a
a
a
a
a
a
a
a
a
a
a
a
a
a
a
a
a
a
a
a
a
a
a
a
a
a
a
a
a
a
a
a
a
a
a
a
a
a
a
a
a
a
a
a
a
a
a
a
a
a
a
a
a
a
a
a
a
a
a
a
a
a
a
a
a
a
a
a
a
a
a
a
a
a
a
a
a
a
a
a
a
a
a
"}
(109,1,1) = {"
a
a
a
a
a
a
a
a
a
a
a
a
a
a
a
a
a
a
a
a
a
a
a
a
a
a
a
a
a
a
a
a
a
a
a
a
a
a
a
a
a
a
a
a
a
a
a
a
a
a
a
a
a
a
a
a
a
a
a
a
a
a
a
a
a
a
a
a
a
a
a
a
a
a
a
a
a
a
a
a
a
a
a
a
a
a
a
a
a
a
a
a
a
a
a
a
a
a
a
a
a
a
a
a
a
a
a
a
a
a
a
a
a
a
"}
(110,1,1) = {"
a
a
a
a
a
a
a
a
a
a
a
a
a
a
a
a
a
a
a
a
a
a
a
a
a
a
a
a
a
a
a
a
a
a
a
a
a
a
a
a
a
a
a
a
a
a
a
a
a
a
a
a
a
a
a
a
a
a
a
a
a
a
a
a
a
a
a
a
a
a
a
a
a
a
a
a
a
a
a
a
a
a
a
a
a
a
a
a
a
a
a
a
a
a
a
a
a
a
a
a
a
a
a
a
a
a
a
a
a
a
a
a
a
a
"}
(111,1,1) = {"
a
a
a
a
a
a
a
a
a
a
a
a
a
a
a
a
a
a
a
a
a
a
a
a
a
a
a
a
a
a
a
a
a
a
a
a
a
a
a
a
a
a
a
a
a
a
a
a
a
a
a
a
a
a
a
a
a
a
a
a
a
a
a
a
a
a
a
a
a
a
a
a
a
a
a
a
a
a
a
a
a
a
a
a
a
a
a
a
a
a
a
a
a
a
a
a
a
a
a
a
a
a
a
a
a
a
a
a
a
a
a
a
a
a
"}
(112,1,1) = {"
a
a
a
a
a
a
a
a
a
a
a
a
a
a
a
a
a
a
a
a
a
a
a
a
a
a
a
a
a
a
a
a
a
a
a
a
a
a
a
a
a
a
a
a
a
a
a
a
a
a
a
a
a
a
a
a
a
a
a
a
a
a
a
a
a
a
a
a
a
a
a
a
a
a
a
a
a
a
a
a
a
a
a
a
a
a
a
a
a
a
a
a
a
a
a
a
a
a
a
a
a
a
a
a
a
a
a
a
a
a
a
a
a
a
"}
(113,1,1) = {"
a
a
a
a
a
a
a
a
a
a
a
a
a
a
a
a
a
a
a
a
a
a
a
a
a
a
a
a
a
a
a
a
a
a
a
a
a
a
a
a
a
a
a
a
a
a
a
a
a
a
a
a
a
a
a
a
a
a
a
a
a
a
a
a
a
a
a
a
a
a
a
a
a
a
a
a
a
a
a
a
a
a
a
a
a
a
a
a
a
a
a
a
a
a
a
a
a
a
a
a
a
a
a
a
a
a
a
a
a
a
a
a
a
a
"}
(114,1,1) = {"
a
a
a
a
a
a
a
a
a
a
a
a
a
a
a
a
a
a
a
a
a
a
a
a
a
a
a
a
a
a
a
a
a
a
a
a
a
a
a
a
a
a
a
a
a
a
a
a
a
a
a
a
a
a
a
a
a
a
a
a
a
a
a
a
a
a
a
a
a
a
a
a
a
a
a
a
a
a
a
a
a
a
a
a
a
a
a
a
a
a
a
a
a
a
a
a
a
a
a
a
a
a
a
a
a
a
a
a
a
a
a
a
a
a
"}
